City,State,Confirmed,Deaths,Recovered,Active
Abbeville,South Carolina,10,0,0,10
Acadia,Louisiana,110,6,0,104
Accomack,Virginia,28,0,0,28
Ada,Idaho,576,9,0,567
Adair,Iowa,1,0,0,1
Adair,Kentucky,45,3,0,42
Adair,Missouri,12,0,0,12
Adair,Oklahoma,29,3,0,26
Adams,Colorado,805,29,0,776
Adams,Idaho,1,0,0,1
Adams,Illinois,30,0,0,30
Adams,Indiana,6,1,0,5
Adams,Mississippi,73,5,0,68
Adams,Nebraska,64,0,0,64
Adams,Ohio,3,0,0,3
Adams,Pennsylvania,70,1,0,69
Adams,Washington,40,0,0,40
Adams,Wisconsin,4,1,0,3
Addison,Vermont,57,1,0,56
Aiken,South Carolina,66,3,0,63
Aitkin,Minnesota,1,0,0,1
Alachua,Florida,202,0,0,202
Alamance,North Carolina,47,0,0,47
Alameda,California,1063,40,0,1023
Alamosa,Colorado,7,2,0,5
Albany,New York,619,20,0,599
Albany,Wyoming,6,0,0,6
Albemarle,Virginia,56,0,0,56
Alcona,Michigan,1,0,0,1
Alcorn,Mississippi,7,0,0,7
Alexander,Illinois,1,0,0,1
Alexander,North Carolina,3,0,0,3
Alexandria,Virginia,321,7,0,314
Alfalfa,Oklahoma,1,0,0,1
Allamakee,Iowa,27,3,0,24
Allegan,Michigan,29,0,0,29
Allegany,Maryland,26,1,0,25
Allegany,New York,29,1,0,28
Alleghany,North Carolina,2,0,0,2
Alleghany,Virginia,4,0,0,4
Allegheny,Pennsylvania,947,43,0,904
Allen,Indiana,271,19,0,252
Allen,Kentucky,4,0,0,4
Allen,Louisiana,79,9,0,70
Allen,Ohio,65,9,0,56
Allendale,South Carolina,6,0,0,6
Alpena,Michigan,2,0,0,2
Alpine,California,2,0,0,2
Amador,California,7,0,0,7
Amelia,Virginia,13,0,0,13
Amherst,Virginia,10,0,0,10
Amite,Mississippi,17,1,0,16
Anchorage,Alaska,150,4,0,146
Anderson,Kansas,0,0,0,0
Anderson,Kentucky,5,1,0,4
Anderson,South Carolina,127,5,0,122
Anderson,Tennessee,16,1,0,15
Anderson,Texas,6,0,0,6
Andrew,Missouri,1,0,0,1
Andrews,Texas,19,0,0,19
Androscoggin,Maine,32,1,0,31
Angelina,Texas,23,0,0,23
Anne Arundel,Maryland,966,34,0,932
Anoka,Minnesota,83,1,0,82
Anson,North Carolina,15,0,0,15
Antelope,Nebraska,1,0,0,1
Antrim,Michigan,8,0,0,8
Apache,Arizona,141,0,0,141
Appanoose,Iowa,2,1,0,1
Appling,Georgia,18,0,0,18
Appomattox,Virginia,7,0,0,7
Aransas,Texas,2,0,0,2
Arapahoe,Colorado,1342,55,0,1287
Archuleta,Colorado,6,0,0,6
Arenac,Michigan,7,0,0,7
Arkansas,Arkansas,2,0,0,2
Arlington,Virginia,485,16,0,469
Armstrong,Pennsylvania,32,2,0,30
Armstrong,Texas,1,0,0,1
Aroostook,Maine,2,0,0,2
Ascension,Louisiana,468,30,0,438
Ashe,North Carolina,4,0,0,4
Ashland,Ohio,5,0,0,5
Ashland,Wisconsin,2,0,0,2
Ashley,Arkansas,11,0,0,11
Ashtabula,Ohio,54,4,0,50
Asotin,Washington,11,0,0,11
Assumption,Louisiana,137,1,0,136
Atascosa,Texas,10,1,0,9
Atchison,Kansas,4,0,0,4
Atchison,Missouri,2,0,0,2
Athens,Ohio,3,1,0,2
Atkinson,Georgia,5,0,0,5
Atlantic,New Jersey,370,17,0,353
Atoka,Oklahoma,1,0,0,1
Attala,Mississippi,31,0,0,31
Audubon,Iowa,1,0,0,1
Auglaize,Ohio,21,1,0,20
Augusta,Virginia,19,0,0,19
Aurora,South Dakota,1,0,0,1
Austin,Texas,12,0,0,12
Autauga,Alabama,26,2,0,24
Avoyelles,Louisiana,68,3,0,65
Baca,Colorado,10,0,0,10
Bacon,Georgia,17,1,0,16
Baker,Florida,17,3,0,14
Baker,Georgia,19,2,0,17
Baldwin,Alabama,103,2,0,101
Baldwin,Georgia,109,2,0,107
Ballard,Kentucky,3,0,0,3
Baltimore,Maryland,1569,37,0,1532
Baltimore City,Maryland,1273,38,0,1235
Bamberg,South Carolina,7,0,0,7
Bandera,Texas,4,0,0,4
Banks,Georgia,13,0,0,13
Bannock,Idaho,8,0,0,8
Baraga,Michigan,0,0,0,0
Barber,Kansas,1,0,0,1
Barbour,Alabama,15,0,0,15
Barbour,West Virginia,4,0,0,4
Barnes,North Dakota,2,0,0,2
Barnstable,Massachusetts,573,18,0,555
Barnwell,South Carolina,5,0,0,5
Barren,Kentucky,6,0,0,6
Barron,Wisconsin,6,0,0,6
Barrow,Georgia,84,3,0,81
Barry,Michigan,21,1,0,20
Barry,Missouri,3,0,0,3
Bartholomew,Indiana,130,6,0,124
Barton,Kansas,6,0,0,6
Bartow,Georgia,242,22,0,220
Bastrop,Texas,42,1,0,41
Bates,Missouri,6,1,0,5
Bath,Kentucky,3,0,0,3
Bath,Virginia,0,0,0,0
Baxter,Arkansas,4,0,0,4
Bay,Florida,44,2,0,42
Bay,Michigan,69,2,0,67
Bayfield,Wisconsin,3,0,0,3
Beadle,South Dakota,21,2,0,19
Beaufort,North Carolina,14,0,0,14
Beaufort,South Carolina,214,6,0,208
Beauregard,Louisiana,35,2,0,33
Beaver,Oklahoma,1,0,0,1
Beaver,Pennsylvania,178,15,0,163
Beaverhead,Montana,1,0,0,1
Becker,Minnesota,1,0,0,1
Beckham,Oklahoma,2,0,0,2
Bedford,Pennsylvania,13,1,0,12
Bedford,Tennessee,40,2,0,38
Bedford,Virginia,17,0,0,17
Bee,Texas,5,0,0,5
Belknap,New Hampshire,25,0,0,25
Bell,Texas,124,3,0,121
Belmont,Ohio,63,3,0,60
Beltrami,Minnesota,5,0,0,5
Ben Hill,Georgia,13,0,0,13
Bennington,Vermont,33,1,0,32
Benton,Arkansas,62,0,0,62
Benton,Indiana,4,0,0,4
Benton,Iowa,21,1,0,20
Benton,Minnesota,4,0,0,4
Benton,Mississippi,6,0,0,6
Benton,Missouri,3,0,0,3
Benton,Oregon,27,4,0,23
Benton,Tennessee,4,0,0,4
Benton,Washington,295,34,0,261
Benzie,Michigan,0,0,0,0
Bergen,New Jersey,11863,714,0,11149
Berkeley,South Carolina,123,3,0,120
Berkeley,West Virginia,106,1,0,105
Berks,Pennsylvania,1537,34,0,1503
Berkshire,Massachusetts,383,24,0,359
Bernalillo,New Mexico,491,18,0,473
Berrien,Georgia,10,0,0,10
Berrien,Michigan,144,8,0,136
Bertie,North Carolina,18,1,0,17
Bethel,Alaska,1,0,0,1
Bexar,Texas,918,37,0,881
Bibb,Alabama,24,0,0,24
Bibb,Georgia,188,1,0,187
Bienville,Louisiana,58,9,0,49
Big Horn,Montana,3,0,0,3
Big Horn,Wyoming,1,0,0,1
Big Stone,Minnesota,1,0,0,1
Bingham,Idaho,3,0,0,3
Black Hawk,Iowa,138,1,0,137
Blackford,Indiana,6,1,0,5
Bladen,North Carolina,2,0,0,2
Blaine,Idaho,473,5,0,468
Blair,Pennsylvania,14,0,0,14
Blanco,Texas,5,0,0,5
Bland,Virginia,0,0,0,0
Bleckley,Georgia,4,0,0,4
Bledsoe,Tennessee,7,0,0,7
Blount,Alabama,20,0,0,20
Blount,Tennessee,46,3,0,43
Blue Earth,Minnesota,23,0,0,23
Bolivar,Mississippi,76,5,0,71
Bollinger,Missouri,3,0,0,3
Bon Homme,South Dakota,4,0,0,4
Bond,Illinois,4,1,0,3
Bonner,Idaho,4,0,0,4
Bonneville,Idaho,24,0,0,24
Boone,Arkansas,3,0,0,3
Boone,Illinois,21,2,0,19
Boone,Indiana,145,7,0,138
Boone,Iowa,4,0,0,4
Boone,Kentucky,73,2,0,71
Boone,Missouri,93,1,0,92
Boone,West Virginia,2,0,0,2
Bosque,Texas,1,0,0,1
Bossier,Louisiana,230,11,0,219
Botetourt,Virginia,23,0,0,23
Boulder,Colorado,312,15,0,297
Boundary,Idaho,0,0,0,0
Bourbon,Kansas,7,1,0,6
Bourbon,Kentucky,5,1,0,4
Bowie,Texas,53,1,0,52
Bowman,North Dakota,1,0,0,1
Box Butte,Nebraska,1,0,0,1
Box Elder,Utah,54,0,0,54
Boyd,Kentucky,29,2,0,27
Boyle,Kentucky,13,0,0,13
Bracken,Kentucky,7,0,0,7
Bradford,Florida,40,2,0,38
Bradford,Pennsylvania,20,0,0,20
Bradley,Arkansas,7,0,0,7
Bradley,Tennessee,35,1,0,34
Branch,Michigan,35,2,0,33
Brantley,Georgia,16,1,0,15
Braxton,West Virginia,1,0,0,1
Brazoria,Texas,285,3,0,282
Brazos,Texas,164,15,0,149
Breathitt,Kentucky,1,0,0,1
Breckinridge,Kentucky,5,0,0,5
Bremer,Iowa,23,0,0,23
Brevard,Florida,205,7,0,198
Bristol,Massachusetts,1659,63,0,1596
Bristol,Rhode Island,57,0,0,57
Bristol,Virginia,1,0,0,1
Broadwater,Montana,4,0,0,4
Brooke,West Virginia,3,0,0,3
Brookings,South Dakota,9,0,0,9
Brooks,Georgia,23,3,0,20
Broome,New York,178,8,0,170
Broomfield,Colorado,95,2,0,93
Broward,Florida,3688,107,0,3581
Brown,Indiana,14,1,0,13
Brown,Minnesota,7,1,0,6
Brown,Ohio,8,1,0,7
Brown,South Dakota,17,0,0,17
Brown,Texas,12,1,0,11
Brown,Wisconsin,180,1,0,179
Brule,South Dakota,0,0,0,0
Brunswick,North Carolina,36,2,0,34
Brunswick,Virginia,10,0,0,10
Bryan,Georgia,31,2,0,29
Bryan,Oklahoma,5,0,0,5
Buchanan,Iowa,8,0,0,8
Buchanan,Missouri,28,1,0,27
Buchanan,Virginia,12,0,0,12
Buckingham,Virginia,24,0,0,24
Bucks,Pennsylvania,1546,67,0,1479
Buena Vista,Iowa,2,0,0,2
Buena Vista,Virginia,5,0,0,5
Buffalo,Nebraska,44,1,0,43
Buffalo,Wisconsin,4,1,0,3
Bullitt,Kentucky,31,2,0,29
Bulloch,Georgia,26,1,0,25
Bullock,Alabama,8,0,0,8
Buncombe,North Carolina,47,3,0,44
Bureau,Illinois,7,0,0,7
Burke,Georgia,37,2,0,35
Burke,North Carolina,66,5,0,61
Burke,North Dakota,2,0,0,2
Burleigh,North Dakota,54,0,0,54
Burleson,Texas,9,0,0,9
Burlington,New Jersey,1366,54,0,1312
Burnet,Texas,8,0,0,8
Burt,Nebraska,1,0,0,1
Butler,Alabama,16,0,0,16
Butler,Iowa,1,0,0,1
Butler,Kansas,11,0,0,11
Butler,Kentucky,51,1,0,50
Butler,Missouri,22,0,0,22
Butler,Ohio,155,2,0,153
Butler,Pennsylvania,157,5,0,152
Butte,California,16,0,0,16
Butte,South Dakota,0,0,0,0
Butts,Georgia,40,0,0,40
Cabarrus,North Carolina,207,4,0,203
Cabell,West Virginia,28,0,0,28
Caddo,Louisiana,1220,56,0,1164
Caddo,Oklahoma,48,2,0,46
Calaveras,California,11,0,0,11
Calcasieu,Louisiana,309,16,0,293
Caldwell,Kentucky,11,0,0,11
Caldwell,Louisiana,19,0,0,19
Caldwell,Missouri,2,0,0,2
Caldwell,North Carolina,22,0,0,22
Caldwell,Texas,7,0,0,7
Caledonia,Vermont,10,0,0,10
Calhoun,Alabama,63,2,0,61
Calhoun,Florida,6,0,0,6
Calhoun,Georgia,60,2,0,58
Calhoun,Illinois,1,0,0,1
Calhoun,Michigan,130,5,0,125
Calhoun,Mississippi,32,2,0,30
Calhoun,South Carolina,6,1,0,5
Calhoun,Texas,21,0,0,21
Callahan,Texas,1,0,0,1
Callaway,Missouri,21,1,0,20
Calloway,Kentucky,22,1,0,21
Calumet,Wisconsin,5,0,0,5
Calvert,Maryland,109,2,0,107
Camas,Idaho,1,0,0,1
Cambria,Pennsylvania,14,1,0,13
Camden,Georgia,27,0,0,27
Camden,Missouri,32,1,0,31
Camden,New Jersey,1807,64,0,1743
Cameron,Louisiana,2,0,0,2
Cameron,Pennsylvania,1,0,0,1
Cameron,Texas,270,4,0,266
Camp,Texas,6,0,0,6
Campbell,Kentucky,55,5,0,50
Campbell,Tennessee,12,1,0,11
Campbell,Virginia,9,0,0,9
Campbell,Wyoming,13,0,0,13
Canadian,Oklahoma,65,3,0,62
Candler,Georgia,4,0,0,4
Cannon,Tennessee,8,0,0,8
Canyon,Idaho,181,5,0,176
Cape Girardeau,Missouri,35,1,0,34
Cape May,New Jersey,189,14,0,175
Carbon,Montana,6,0,0,6
Carbon,Pennsylvania,118,7,0,111
Carbon,Wyoming,4,0,0,4
Caribou,Idaho,1,0,0,1
Carlton,Minnesota,32,0,0,32
Caroline,Maryland,28,0,0,28
Caroline,Virginia,11,0,0,11
Carroll,Arkansas,2,0,0,2
Carroll,Georgia,260,7,0,253
Carroll,Illinois,5,1,0,4
Carroll,Indiana,6,1,0,5
Carroll,Iowa,1,0,0,1
Carroll,Kentucky,2,0,0,2
Carroll,Maryland,288,25,0,263
Carroll,Mississippi,10,1,0,9
Carroll,New Hampshire,32,0,0,32
Carroll,Ohio,15,0,0,15
Carroll,Tennessee,13,0,0,13
Carroll,Virginia,3,0,0,3
Carson City,Nevada,27,0,0,27
Carter,Kentucky,4,0,0,4
Carter,Missouri,3,1,0,2
Carter,Oklahoma,1,0,0,1
Carter,Tennessee,5,1,0,4
Carteret,North Carolina,22,1,0,21
Carver,Minnesota,14,0,0,14
Cascade,Montana,13,0,0,13
Casey,Kentucky,1,0,0,1
Cass,Indiana,50,1,0,49
Cass,Iowa,1,0,0,1
Cass,Michigan,22,1,0,21
Cass,Minnesota,4,0,0,4
Cass,Missouri,50,5,0,45
Cass,Nebraska,3,0,0,3
Cass,North Dakota,152,2,0,150
Cass,Texas,6,0,0,6
Cassia,Idaho,10,1,0,9
Castro,Texas,11,1,0,10
Caswell,North Carolina,7,0,0,7
Catahoula,Louisiana,23,1,0,22
Catawba,North Carolina,43,1,0,42
Catoosa,Georgia,18,0,0,18
Catron,New Mexico,1,0,0,1
Cattaraugus,New York,34,0,0,34
Cayuga,New York,36,1,0,35
Cecil,Maryland,127,2,0,125
Cedar,Iowa,23,0,0,23
Cedar,Missouri,5,0,0,5
Cedar,Nebraska,0,0,0,0
Centre,Pennsylvania,73,1,0,72
Cerro Gordo,Iowa,14,0,0,14
Chaffee,Colorado,35,4,0,31
Chambers,Alabama,236,11,0,225
Chambers,Texas,34,0,0,34
Champaign,Illinois,92,4,0,88
Champaign,Ohio,6,1,0,5
Chariton,Missouri,4,0,0,4
Charles,Maryland,337,15,0,322
Charles City,Virginia,10,0,0,10
Charles Mix,South Dakota,4,0,0,4
Charleston,South Carolina,385,3,0,382
Charlevoix,Michigan,11,1,0,10
Charlotte,Florida,131,9,0,122
Charlotte,Virginia,8,0,0,8
Charlottesville,Virginia,40,1,0,39
Charlton,Georgia,5,0,0,5
Chase,Kansas,1,0,0,1
Chatham,Georgia,173,5,0,168
Chatham,North Carolina,85,1,0,84
Chattahoochee,Georgia,6,0,0,6
Chattooga,Georgia,9,1,0,8
Chautauqua,Kansas,3,0,0,3
Chautauqua,New York,25,3,0,22
Chaves,New Mexico,19,0,0,19
Cheatham,Tennessee,20,0,0,20
Cheboygan,Michigan,12,1,0,11
Chelan,Washington,66,6,0,60
Chemung,New York,71,1,0,70
Chenango,New York,76,0,0,76
Cherokee,Alabama,12,0,0,12
Cherokee,Georgia,266,8,0,258
Cherokee,Kansas,7,0,0,7
Cherokee,North Carolina,16,1,0,15
Cherokee,Oklahoma,22,1,0,21
Cherokee,South Carolina,13,0,0,13
Cherokee,Texas,10,1,0,9
Cherry,Nebraska,1,0,0,1
Chesapeake,Virginia,147,4,0,143
Cheshire,New Hampshire,27,0,0,27
Chester,Pennsylvania,739,30,0,709
Chester,South Carolina,23,0,0,23
Chester,Tennessee,6,0,0,6
Chesterfield,South Carolina,31,0,0,31
Chesterfield,Virginia,291,0,0,291
Cheyenne,Nebraska,3,0,0,3
Chickasaw,Iowa,2,0,0,2
Chickasaw,Mississippi,39,2,0,37
Chicot,Arkansas,7,0,0,7
Chilton,Alabama,37,0,0,37
Chippewa,Michigan,0,0,0,0
Chippewa,Wisconsin,20,0,0,20
Chisago,Minnesota,7,1,0,6
Chittenden,Vermont,378,22,0,356
Choctaw,Alabama,13,0,0,13
Choctaw,Mississippi,11,1,0,10
Choctaw,Oklahoma,3,0,0,3
Chowan,North Carolina,6,0,0,6
Christian,Illinois,24,4,0,20
Christian,Kentucky,78,3,0,75
Christian,Missouri,19,0,0,19
Churchill,Nevada,1,0,0,1
Cibola,New Mexico,30,2,0,28
Citrus,Florida,82,8,0,74
Clackamas,Oregon,153,4,0,149
Claiborne,Louisiana,48,4,0,44
Claiborne,Mississippi,8,0,0,8
Claiborne,Tennessee,5,0,0,5
Clallam,Washington,15,0,0,15
Clare,Michigan,7,1,0,6
Clarendon,South Carolina,106,6,0,100
Clarion,Pennsylvania,18,0,0,18
Clark,Arkansas,27,0,0,27
Clark,Illinois,4,0,0,4
Clark,Indiana,151,10,0,141
Clark,Kentucky,18,0,0,18
Clark,Missouri,1,0,0,1
Clark,Nevada,2738,124,0,2614
Clark,Ohio,25,0,0,25
Clark,South Dakota,1,0,0,1
Clark,Washington,277,16,0,261
Clark,Wisconsin,12,0,0,12
Clarke,Alabama,24,0,0,24
Clarke,Georgia,106,12,0,94
Clarke,Iowa,2,0,0,2
Clarke,Mississippi,21,1,0,20
Clarke,Virginia,6,0,0,6
Clatsop,Oregon,6,0,0,6
Clay,Alabama,14,0,0,14
Clay,Arkansas,1,0,0,1
Clay,Florida,216,9,0,207
Clay,Georgia,19,2,0,17
Clay,Illinois,1,0,0,1
Clay,Indiana,14,0,0,14
Clay,Iowa,2,0,0,2
Clay,Kansas,2,0,0,2
Clay,Minnesota,44,2,0,42
Clay,Mississippi,22,1,0,21
Clay,Missouri,55,1,0,54
Clay,Nebraska,2,0,0,2
Clay,North Carolina,5,0,0,5
Clay,South Dakota,5,0,0,5
Clay,Tennessee,5,0,0,5
Clay,Texas,3,0,0,3
Clayton,Georgia,491,14,0,477
Clayton,Iowa,7,1,0,6
Clear Creek,Colorado,11,0,0,11
Clearfield,Pennsylvania,9,0,0,9
Clearwater,Minnesota,3,0,0,3
Cleburne,Alabama,12,0,0,12
Cleburne,Arkansas,70,4,0,66
Clermont,Ohio,66,1,0,65
Cleveland,Arkansas,8,0,0,8
Cleveland,North Carolina,42,1,0,41
Cleveland,Oklahoma,301,21,0,280
Clinch,Georgia,7,0,0,7
Clinton,Illinois,42,0,0,42
Clinton,Indiana,16,1,0,15
Clinton,Iowa,39,0,0,39
Clinton,Kentucky,2,0,0,2
Clinton,Michigan,103,6,0,97
Clinton,Missouri,11,0,0,11
Clinton,New York,47,3,0,44
Clinton,Ohio,26,0,0,26
Clinton,Pennsylvania,10,0,0,10
Cloud,Kansas,3,0,0,3
Coahoma,Mississippi,45,1,0,44
Cobb,Georgia,1072,51,0,1021
Cochise,Arizona,20,0,0,20
Cocke,Tennessee,11,0,0,11
Coconino,Arizona,304,26,0,278
Codington,South Dakota,13,0,0,13
Coffee,Alabama,51,0,0,51
Coffee,Georgia,73,3,0,70
Coffee,Tennessee,17,0,0,17
Coffey,Kansas,45,6,0,39
Colbert,Alabama,13,1,0,12
Cole,Missouri,42,1,0,41
Coles,Illinois,9,0,0,9
Colfax,Nebraska,4,0,0,4
Colfax,New Mexico,3,0,0,3
Colleton,South Carolina,21,1,0,20
Collier,Florida,445,8,0,437
Collin,Texas,505,11,0,494
Colonial Heights,Virginia,19,0,0,19
Colorado,Texas,7,0,0,7
Colquitt,Georgia,115,5,0,110
Columbia,Arkansas,4,0,0,4
Columbia,Florida,35,0,0,35
Columbia,Georgia,90,1,0,89
Columbia,New York,101,10,0,91
Columbia,Oregon,14,0,0,14
Columbia,Pennsylvania,166,3,0,163
Columbia,Washington,1,0,0,1
Columbia,Wisconsin,27,1,0,26
Columbiana,Ohio,154,11,0,143
Columbus,North Carolina,55,2,0,53
Colusa,California,3,0,0,3
Comal,Texas,43,6,0,37
Comanche,Oklahoma,57,0,0,57
Comanche,Texas,3,0,0,3
Concho,Texas,1,0,0,1
Concordia,Louisiana,23,2,0,21
Conecuh,Alabama,8,0,0,8
Contra Costa,California,648,19,0,629
Converse,Wyoming,8,0,0,8
Conway,Arkansas,5,1,0,4
Cook,Georgia,11,1,0,10
Cook,Illinois,19391,760,0,18631
Cooke,Texas,4,0,0,4
Cooper,Missouri,4,0,0,4
Coos,New Hampshire,2,0,0,2
Coos,Oregon,1,0,0,1
Coosa,Alabama,20,1,0,19
Copiah,Mississippi,40,1,0,39
Corson,South Dakota,1,0,0,1
Cortland,New York,25,0,0,25
Coryell,Texas,71,1,0,70
Coshocton,Ohio,16,0,0,16
Costilla,Colorado,3,0,0,3
Cotton,Oklahoma,5,0,0,5
Cottonwood,Minnesota,6,0,0,6
Covington,Alabama,19,1,0,18
Covington,Mississippi,22,0,0,22
Covington,Virginia,1,0,0,1
Coweta,Georgia,149,3,0,146
Cowley,Kansas,1,1,0,0
Cowlitz,Washington,26,0,0,26
Craig,Oklahoma,7,0,0,7
Craig,Virginia,2,0,0,2
Craighead,Arkansas,40,1,0,39
Crane,Texas,2,0,0,2
Craven,North Carolina,33,1,0,32
Crawford,Arkansas,4,0,0,4
Crawford,Georgia,13,0,0,13
Crawford,Illinois,4,0,0,4
Crawford,Indiana,12,0,0,12
Crawford,Iowa,6,1,0,5
Crawford,Kansas,6,1,0,5
Crawford,Michigan,22,2,0,20
Crawford,Missouri,6,0,0,6
Crawford,Ohio,28,0,0,28
Crawford,Pennsylvania,16,0,0,16
Crawford,Wisconsin,3,0,0,3
Creek,Oklahoma,58,3,0,55
Crenshaw,Alabama,5,0,0,5
Crisp,Georgia,110,1,0,109
Crittenden,Arkansas,127,4,0,123
Crittenden,Kentucky,3,0,0,3
Crockett,Tennessee,0,0,0,0
Crook,Oregon,1,0,0,1
Crook,Wyoming,4,0,0,4
Crosby,Texas,1,1,0,0
Cross,Arkansas,8,0,0,8
Crow Wing,Minnesota,17,0,0,17
Crowley,Colorado,2,1,0,1
Cullman,Alabama,53,1,0,52
Culpeper,Virginia,32,0,0,32
Cumberland,Illinois,2,0,0,2
Cumberland,Kentucky,2,0,0,2
Cumberland,Maine,360,14,0,346
Cumberland,New Jersey,263,3,0,260
Cumberland,North Carolina,105,6,0,99
Cumberland,Pennsylvania,154,4,0,150
Cumberland,Tennessee,55,0,0,55
Cumberland,Virginia,8,0,0,8
Cuming,Nebraska,2,0,0,2
Currituck,North Carolina,3,0,0,3
Curry,New Mexico,10,0,0,10
Curry,Oregon,3,0,0,3
Custer,Colorado,2,0,0,2
Custer,Idaho,2,0,0,2
Custer,Nebraska,19,0,0,19
Custer,Oklahoma,7,0,0,7
Cuyahoga,Ohio,1383,48,0,1335
Dade,Georgia,7,1,0,6
Dakota,Minnesota,110,5,0,105
Dakota,Nebraska,9,0,0,9
Dale,Alabama,14,0,0,14
Dallam,Texas,3,0,0,3
Dallas,Alabama,21,2,0,19
Dallas,Arkansas,1,0,0,1
Dallas,Iowa,44,0,0,44
Dallas,Missouri,2,0,0,2
Dallas,Texas,2190,55,0,2135
Dane,Wisconsin,359,17,0,342
Danville,Virginia,22,0,0,22
Dare,North Carolina,15,1,0,14
Darke,Ohio,55,10,0,45
Darlington,South Carolina,52,0,0,52
Dauphin,Pennsylvania,311,7,0,304
Davidson,North Carolina,94,2,0,92
Davidson,Tennessee,1307,19,0,1288
Davie,North Carolina,23,2,0,21
Daviess,Indiana,27,1,0,26
Daviess,Kentucky,105,3,0,102
Daviess,Missouri,2,0,0,2
Davis,Utah,227,2,0,225
Davison,South Dakota,3,0,0,3
Dawson,Georgia,42,2,0,40
Dawson,Nebraska,24,0,0,24
Dawson,Texas,12,1,0,11
De Soto,Louisiana,145,8,0,137
De Witt,Illinois,1,0,0,1
DeKalb,Alabama,34,2,0,32
DeKalb,Georgia,1349,23,0,1326
DeKalb,Illinois,46,1,0,45
DeKalb,Indiana,11,1,0,10
DeKalb,Missouri,3,0,0,3
DeKalb,Tennessee,10,0,0,10
DeSoto,Florida,23,3,0,20
DeSoto,Mississippi,213,3,0,210
DeWitt,Texas,10,0,0,10
Deaf Smith,Texas,11,0,0,11
Dearborn,Indiana,63,5,0,58
Decatur,Georgia,55,0,0,55
Decatur,Indiana,165,17,0,148
Decatur,Tennessee,3,0,0,3
Deer Lodge,Montana,3,0,0,3
Defiance,Ohio,13,0,0,13
Del Norte,California,2,0,0,2
Delaware,Indiana,91,5,0,86
Delaware,Iowa,2,0,0,2
Delaware,New York,48,3,0,45
Delaware,Ohio,119,3,0,116
Delaware,Oklahoma,74,2,0,72
Delaware,Pennsylvania,2226,73,0,2153
Delta,Colorado,13,1,0,12
Delta,Michigan,10,1,0,9
Delta,Texas,1,0,0,1
Denton,Texas,564,15,0,549
Denver,Colorado,1549,63,0,1486
Des Moines,Iowa,8,0,0,8
Deschutes,Oregon,61,0,0,61
Desha,Arkansas,6,0,0,6
Deuel,South Dakota,1,0,0,1
Dewey,Oklahoma,2,0,0,2
Dickens,Texas,1,0,0,1
Dickenson,Virginia,0,0,0,0
Dickinson,Iowa,1,0,0,1
Dickinson,Kansas,1,0,0,1
Dickinson,Michigan,3,2,0,1
Dickson,Tennessee,39,0,0,39
Dillon,South Carolina,11,0,0,11
Dimmit,Texas,1,0,0,1
Dinwiddie,Virginia,7,0,0,7
District of Columbia,District of Columbia,2476,86,0,2390
Divide,North Dakota,1,0,0,1
Dixie,Florida,3,0,0,3
Dodge,Georgia,19,0,0,19
Dodge,Minnesota,17,0,0,17
Dodge,Nebraska,12,0,0,12
Dodge,Wisconsin,20,1,0,19
Dona Ana,New Mexico,58,1,0,57
Doniphan,Kansas,1,0,0,1
Donley,Texas,23,0,0,23
Dooly,Georgia,66,4,0,62
Door,Wisconsin,9,1,0,8
Dorchester,Maryland,20,1,0,19
Dorchester,South Carolina,83,1,0,82
Dougherty,Georgia,1381,91,0,1290
Douglas,Colorado,329,15,0,314
Douglas,Georgia,220,6,0,214
Douglas,Illinois,12,0,0,12
Douglas,Kansas,42,0,0,42
Douglas,Minnesota,1,0,0,1
Douglas,Nebraska,266,5,0,261
Douglas,Nevada,14,0,0,14
Douglas,Oregon,22,0,0,22
Douglas,Washington,34,1,0,33
Douglas,Wisconsin,7,0,0,7
Drew,Arkansas,6,1,0,5
DuPage,Illinois,1560,77,0,1483
Dubois,Indiana,14,0,0,14
Dubuque,Iowa,40,1,0,39
Dukes and Nantucket,Massachusetts,21,1,0,20
Dunklin,Missouri,18,2,0,16
Dunn,North Dakota,4,0,0,4
Dunn,Wisconsin,9,0,0,9
Duplin,North Carolina,23,0,0,23
Durham,North Carolina,388,4,0,384
Dutchess,New York,2142,19,0,2123
Duval,Florida,817,15,0,802
Duval,Texas,1,0,0,1
Dyer,Tennessee,24,0,0,24
Eagle,Colorado,479,6,0,473
Early,Georgia,163,8,0,155
East Baton Rouge,Louisiana,1424,66,0,1358
East Carroll,Louisiana,1,0,0,1
East Feliciana,Louisiana,90,7,0,83
Eastland,Texas,3,0,0,3
Eaton,Michigan,87,5,0,82
Eau Claire,Wisconsin,22,0,0,22
Echols,Georgia,4,0,0,4
Ector,Texas,55,2,0,53
Eddy,New Mexico,7,1,0,6
Eddy,North Dakota,1,0,0,1
Edgecombe,North Carolina,46,1,0,45
Edgefield,South Carolina,10,0,0,10
Edmonson,Kentucky,7,0,0,7
Effingham,Georgia,25,1,0,24
Effingham,Illinois,4,1,0,3
El Dorado,California,36,0,0,36
El Paso,Colorado,689,48,0,641
El Paso,Texas,451,7,0,444
Elbert,Colorado,17,1,0,16
Elbert,Georgia,7,0,0,7
Elk,Pennsylvania,2,0,0,2
Elkhart,Indiana,130,3,0,127
Elko,Nevada,12,1,0,11
Ellis,Kansas,4,0,0,4
Ellis,Texas,82,3,0,79
Elmore,Alabama,54,1,0,53
Elmore,Idaho,18,0,0,18
Emanuel,Georgia,12,0,0,12
Emmet,Michigan,21,2,0,19
Emmons,North Dakota,1,1,0,0
Emporia,Virginia,7,0,0,7
Erath,Texas,13,1,0,12
Erie,New York,2023,107,0,1916
Erie,Ohio,23,1,0,22
Erie,Pennsylvania,48,0,0,48
Escambia,Alabama,14,0,0,14
Escambia,Florida,290,6,0,284
Essex,Massachusetts,4584,159,0,4425
Essex,New Jersey,9672,684,0,8988
Essex,New York,15,0,0,15
Essex,Vermont,1,0,0,1
Essex,Virginia,2,0,0,2
Etowah,Alabama,87,8,0,79
Evangeline,Louisiana,42,0,0,42
Evans,Georgia,2,0,0,2
Fairbanks North Star,Alaska,79,1,0,78
Fairfax,Virginia,1476,37,0,1439
Fairfax City,Virginia,2,0,0,2
Fairfield,Connecticut,7146,425,0,6721
Fairfield,Ohio,95,2,0,93
Fairfield,South Carolina,25,0,0,25
Fall River,South Dakota,1,0,0,1
Falls,Texas,1,0,0,1
Falls Church,Virginia,0,0,0,0
Fannin,Georgia,14,0,0,14
Fannin,Texas,5,0,0,5
Faribault,Minnesota,4,0,0,4
Faulk,South Dakota,1,0,0,1
Faulkner,Arkansas,59,2,0,57
Fauquier,Virginia,35,0,0,35
Fayette,Alabama,4,0,0,4
Fayette,Georgia,133,5,0,128
Fayette,Illinois,12,1,0,11
Fayette,Indiana,21,4,0,17
Fayette,Iowa,6,0,0,6
Fayette,Kentucky,210,7,0,203
Fayette,Ohio,12,0,0,12
Fayette,Pennsylvania,66,3,0,63
Fayette,Tennessee,42,1,0,41
Fayette,Texas,15,0,0,15
Fayette,West Virginia,4,0,0,4
Federal Correctional Institution (FCI),Michigan,44,0,0,44
Fentress,Tennessee,4,0,0,4
Ferry,Washington,1,0,0,1
Fillmore,Minnesota,10,0,0,10
Finney,Kansas,27,1,0,26
Flagler,Florida,55,2,0,53
Flathead,Montana,37,1,0,36
Fleming,Kentucky,2,0,0,2
Florence,South Carolina,121,8,0,113
Florence,Wisconsin,2,0,0,2
Floyd,Georgia,121,6,0,115
Floyd,Indiana,130,6,0,124
Floyd,Kentucky,4,0,0,4
Floyd,Texas,2,0,0,2
Floyd,Virginia,1,0,0,1
Fluvanna,Virginia,64,0,0,64
Fond du Lac,Wisconsin,61,3,0,58
Ford,Illinois,4,1,0,3
Ford,Kansas,84,0,0,84
Forest,Pennsylvania,7,0,0,7
Forrest,Mississippi,137,2,0,135
Forsyth,Georgia,184,6,0,178
Forsyth,North Carolina,126,5,0,121
Fort Bend,Texas,656,16,0,640
Foster,North Dakota,1,0,0,1
Fountain,Indiana,4,2,0,2
Franklin,Alabama,18,1,0,17
Franklin,Arkansas,1,0,0,1
Franklin,Florida,2,0,0,2
Franklin,Georgia,10,0,0,10
Franklin,Illinois,5,0,0,5
Franklin,Indiana,87,7,0,80
Franklin,Iowa,1,0,0,1
Franklin,Kansas,12,0,0,12
Franklin,Kentucky,12,0,0,12
Franklin,Louisiana,67,2,0,65
Franklin,Maine,10,0,0,10
Franklin,Massachusetts,173,25,0,148
Franklin,Mississippi,14,0,0,14
Franklin,Missouri,91,7,0,84
Franklin,Nebraska,3,0,0,3
Franklin,New York,13,0,0,13
Franklin,North Carolina,67,6,0,61
Franklin,Ohio,1320,22,0,1298
Franklin,Pennsylvania,89,0,0,89
Franklin,Tennessee,23,1,0,22
Franklin,Texas,1,0,0,1
Franklin,Vermont,88,3,0,85
Franklin,Virginia,15,0,0,15
Franklin,Washington,162,4,0,158
Franklin City,Virginia,9,0,0,9
Frederick,Maryland,525,23,0,502
Frederick,Virginia,76,0,0,76
Fredericksburg,Virginia,15,0,0,15
Freeborn,Minnesota,28,0,0,28
Freestone,Texas,1,0,0,1
Fremont,Colorado,9,0,0,9
Fremont,Idaho,2,0,0,2
Fremont,Wyoming,45,0,0,45
Fresno,California,295,7,0,288
Frio,Texas,1,0,0,1
Fulton,Georgia,2025,73,0,1952
Fulton,Illinois,1,0,0,1
Fulton,Indiana,4,0,0,4
Fulton,New York,27,0,0,27
Fulton,Ohio,13,0,0,13
Fulton,Pennsylvania,2,0,0,2
Gadsden,Florida,47,0,0,47
Gage,Nebraska,26,1,0,25
Gaines,Texas,2,0,0,2
Galax,Virginia,1,0,0,1
Gallatin,Illinois,2,0,0,2
Gallatin,Kentucky,1,0,0,1
Gallatin,Montana,142,0,0,142
Gallia,Ohio,6,1,0,5
Galveston,Texas,421,14,0,407
Garfield,Colorado,64,2,0,62
Garfield,Oklahoma,9,1,0,8
Garland,Arkansas,107,0,0,107
Garrard,Kentucky,3,0,0,3
Garrett,Maryland,4,0,0,4
Garvin,Oklahoma,10,0,0,10
Gasconade,Missouri,2,0,0,2
Gaston,North Carolina,110,3,0,107
Gates,North Carolina,4,0,0,4
Geary,Kansas,9,0,0,9
Geauga,Ohio,96,4,0,92
Gem,Idaho,10,0,0,10
Genesee,Michigan,1197,106,0,1091
Genesee,New York,83,2,0,81
Geneva,Alabama,2,0,0,2
Gentry,Missouri,1,0,0,1
George,Mississippi,9,0,0,9
Georgetown,South Carolina,34,2,0,32
Gibson,Indiana,4,0,0,4
Gibson,Tennessee,25,0,0,25
Gila,Arizona,5,0,0,5
Gilchrist,Florida,4,0,0,4
Giles,Tennessee,5,0,0,5
Giles,Virginia,4,0,0,4
Gillespie,Texas,1,0,0,1
Gilmer,Georgia,10,0,0,10
Gilpin,Colorado,1,0,0,1
Glacier,Montana,4,0,0,4
Glades,Florida,5,1,0,4
Gladwin,Michigan,8,0,0,8
Glenn,California,4,0,0,4
Gloucester,New Jersey,664,22,0,642
Gloucester,Virginia,20,0,0,20
Glynn,Georgia,46,0,0,46
Gogebic,Michigan,4,1,0,3
Golden Valley,Montana,3,0,0,3
Goliad,Texas,5,0,0,5
Gonzales,Texas,2,0,0,2
Goochland,Virginia,52,0,0,52
Goodhue,Minnesota,18,0,0,18
Gooding,Idaho,7,0,0,7
Gordon,Georgia,53,5,0,48
Goshen,Wyoming,3,0,0,3
Gosper,Nebraska,1,0,0,1
Gove,Kansas,1,0,0,1
Grady,Georgia,27,1,0,26
Grady,Oklahoma,16,1,0,15
Grafton,New Hampshire,44,0,0,44
Graham,Arizona,2,0,0,2
Grainger,Tennessee,4,0,0,4
Grand,Colorado,4,0,0,4
Grand Forks,North Dakota,23,0,0,23
Grand Isle,Vermont,3,0,0,3
Grand Traverse,Michigan,17,4,0,13
Grant,Arkansas,11,0,0,11
Grant,Indiana,47,2,0,45
Grant,Kentucky,16,1,0,15
Grant,Louisiana,12,0,0,12
Grant,New Mexico,12,0,0,12
Grant,North Dakota,1,0,0,1
Grant,Oklahoma,2,0,0,2
Grant,Oregon,1,0,0,1
Grant,Washington,133,2,0,131
Grant,West Virginia,1,0,0,1
Grant,Wisconsin,13,1,0,12
Granville,North Carolina,106,4,0,102
Gratiot,Michigan,7,0,0,7
Graves,Kentucky,28,2,0,26
Gray,Texas,16,0,0,16
Grays Harbor,Washington,12,0,0,12
Grayson,Kentucky,8,0,0,8
Grayson,Texas,19,0,0,19
Grayson,Virginia,0,0,0,0
Green,Kentucky,1,0,0,1
Green,Wisconsin,9,0,0,9
Green Lake,Wisconsin,1,0,0,1
Greenbrier,West Virginia,3,0,0,3
Greene,Alabama,24,0,0,24
Greene,Arkansas,6,0,0,6
Greene,Georgia,40,1,0,39
Greene,Illinois,1,0,0,1
Greene,Indiana,37,3,0,34
Greene,Iowa,1,0,0,1
Greene,Mississippi,3,0,0,3
Greene,Missouri,87,8,0,79
Greene,New York,77,0,0,77
Greene,North Carolina,14,0,0,14
Greene,Ohio,33,2,0,31
Greene,Pennsylvania,24,0,0,24
Greene,Tennessee,29,2,0,27
Greene,Virginia,7,0,0,7
Greenlee,Arizona,2,0,0,2
Greensville,Virginia,18,0,0,18
Greenup,Kentucky,10,0,0,10
Greenville,South Carolina,447,11,0,436
Greenwood,Kansas,2,0,0,2
Greenwood,South Carolina,32,0,0,32
Greer,Oklahoma,50,4,0,46
Gregg,Texas,50,0,0,50
Grenada,Mississippi,15,0,0,15
Grimes,Texas,10,1,0,9
Grundy,Illinois,24,0,0,24
Grundy,Iowa,2,0,0,2
Grundy,Tennessee,25,1,0,24
Guadalupe,Texas,53,0,0,53
Guernsey,Ohio,10,0,0,10
Guilford,North Carolina,171,12,0,159
Gulf,Florida,1,0,0,1
Gunnison,Colorado,111,3,0,108
Guthrie,Iowa,3,0,0,3
Gwinnett,Georgia,1017,36,0,981
Habersham,Georgia,64,2,0,62
Hale,Alabama,22,0,0,22
Hale,Texas,11,2,0,9
Halifax,North Carolina,32,1,0,31
Halifax,Virginia,7,0,0,7
Hall,Georgia,563,6,0,557
Hall,Nebraska,247,4,0,243
Hamblen,Tennessee,7,1,0,6
Hamilton,Florida,3,0,0,3
Hamilton,Indiana,542,31,0,511
Hamilton,Iowa,2,0,0,2
Hamilton,Kansas,1,0,0,1
Hamilton,Nebraska,14,0,0,14
Hamilton,New York,3,0,0,3
Hamilton,Ohio,658,30,0,628
Hamilton,Tennessee,110,11,0,99
Hamilton,Texas,5,0,0,5
Hamlin,South Dakota,2,0,0,2
Hampden,Massachusetts,2134,161,0,1973
Hampshire,Massachusetts,258,6,0,252
Hampshire,West Virginia,6,0,0,6
Hampton,South Carolina,18,0,0,18
Hampton,Virginia,78,1,0,77
Hancock,Georgia,6,0,0,6
Hancock,Illinois,3,0,0,3
Hancock,Indiana,132,6,0,126
Hancock,Iowa,3,0,0,3
Hancock,Kentucky,5,0,0,5
Hancock,Maine,6,0,0,6
Hancock,Mississippi,50,5,0,45
Hancock,Ohio,27,1,0,26
Hancock,Tennessee,0,0,0,0
Hancock,West Virginia,7,0,0,7
Hanover,Virginia,70,0,0,70
Hansford,Texas,1,0,0,1
Haralson,Georgia,19,1,0,18
Hardee,Florida,4,0,0,4
Hardeman,Tennessee,7,0,0,7
Hardin,Iowa,1,0,0,1
Hardin,Kentucky,29,0,0,29
Hardin,Ohio,13,0,0,13
Hardin,Tennessee,4,0,0,4
Hardin,Texas,69,2,0,67
Hardy,West Virginia,3,0,0,3
Harford,Maryland,176,0,0,176
Harnett,North Carolina,54,3,0,51
Harris,Georgia,35,2,0,33
Harris,Texas,4460,67,0,4393
Harrison,Indiana,65,2,0,63
Harrison,Iowa,12,0,0,12
Harrison,Kentucky,16,0,0,16
Harrison,Mississippi,137,5,0,132
Harrison,Missouri,6,0,0,6
Harrison,Ohio,2,0,0,2
Harrison,Texas,40,2,0,38
Harrison,West Virginia,28,1,0,27
Harrisonburg,Virginia,214,0,0,214
Hart,Georgia,5,0,0,5
Hart,Kentucky,1,0,0,1
Hartford,Connecticut,3015,266,0,2749
Harvey,Kansas,5,0,0,5
Hawaii,Hawaii,41,0,0,41
Hawkins,Tennessee,26,2,0,24
Hays,Texas,117,1,0,116
Haywood,North Carolina,5,0,0,5
Haywood,Tennessee,12,1,0,11
Heard,Georgia,5,1,0,4
Hemphill,Texas,1,0,0,1
Hempstead,Arkansas,4,1,0,3
Henderson,Illinois,1,0,0,1
Henderson,Kentucky,25,0,0,25
Henderson,North Carolina,106,11,0,95
Henderson,Tennessee,2,0,0,2
Henderson,Texas,12,0,0,12
Hendricks,Indiana,407,17,0,390
Hendry,Florida,31,0,0,31
Hennepin,Minnesota,806,61,0,745
Henrico,Virginia,532,62,0,470
Henry,Alabama,16,0,0,16
Henry,Georgia,344,5,0,339
Henry,Illinois,28,0,0,28
Henry,Indiana,26,1,0,25
Henry,Iowa,26,1,0,25
Henry,Kentucky,3,0,0,3
Henry,Missouri,6,1,0,5
Henry,Ohio,3,0,0,3
Henry,Tennessee,8,0,0,8
Henry,Virginia,10,0,0,10
Herkimer,New York,46,3,0,43
Hernando,Florida,83,2,0,81
Hertford,North Carolina,7,1,0,6
Hickman,Tennessee,2,0,0,2
Hidalgo,New Mexico,0,0,0,0
Hidalgo,Texas,235,3,0,232
Highland,Ohio,7,0,0,7
Highland,Virginia,0,0,0,0
Highlands,Florida,66,6,0,60
Hill,Montana,1,0,0,1
Hill,Texas,10,1,0,9
Hillsborough,Florida,924,19,0,905
Hillsborough,New Hampshire,525,2,0,523
Hillsdale,Michigan,85,10,0,75
Hinds,Mississippi,314,5,0,309
Hinsdale,Colorado,3,0,0,3
Hocking,Ohio,4,0,0,4
Hockley,Texas,15,1,0,14
Hoke,North Carolina,22,0,0,22
Holmes,Florida,5,0,0,5
Holmes,Mississippi,54,4,0,50
Holmes,Ohio,3,0,0,3
Holt,Missouri,1,0,0,1
Honolulu,Hawaii,373,6,0,367
Hood,Texas,17,3,0,14
Hood River,Oregon,4,0,0,4
Hopewell,Virginia,14,0,0,14
Hopkins,Kentucky,104,9,0,95
Hopkins,Texas,4,0,0,4
Horry,South Carolina,167,10,0,157
Hot Spring,Arkansas,8,0,0,8
Hot Springs,Wyoming,1,0,0,1
Houghton,Michigan,2,0,0,2
Houston,Alabama,64,3,0,61
Houston,Georgia,164,10,0,154
Houston,Minnesota,1,0,0,1
Houston,Tennessee,4,0,0,4
Howard,Arkansas,12,0,0,12
Howard,Indiana,61,4,0,57
Howard,Iowa,2,0,0,2
Howard,Maryland,475,10,0,465
Howard,Missouri,2,0,0,2
Howard,Nebraska,2,0,0,2
Howard,Texas,1,1,0,0
Howell,Missouri,5,0,0,5
Hudson,New Jersey,9636,420,0,9216
Huerfano,Colorado,1,0,0,1
Hughes,South Dakota,5,0,0,5
Humboldt,California,52,0,0,52
Humboldt,Nevada,26,1,0,25
Humphreys,Mississippi,12,3,0,9
Humphreys,Tennessee,4,0,0,4
Hunt,Texas,25,2,0,23
Hunterdon,New Jersey,385,16,0,369
Huntingdon,Pennsylvania,12,0,0,12
Huntington,Indiana,6,1,0,5
Huron,Michigan,8,0,0,8
Huron,Ohio,16,1,0,15
Hutchinson,South Dakota,2,0,0,2
Hutchinson,Texas,6,0,0,6
Hyde,South Dakota,1,0,0,1
Iberia,Louisiana,175,8,0,167
Iberville,Louisiana,267,19,0,248
Idaho,Idaho,3,0,0,3
Imperial,California,143,3,0,140
Independence,Arkansas,7,0,0,7
Indian River,Florida,85,2,0,83
Indiana,Pennsylvania,45,3,0,42
Ingham,Michigan,298,6,0,292
Inyo,California,17,0,0,17
Ionia,Michigan,20,2,0,18
Iosco,Michigan,8,1,0,7
Iowa,Iowa,8,0,0,8
Iowa,Wisconsin,6,0,0,6
Iredell,North Carolina,81,3,0,78
Iron,Missouri,1,0,0,1
Iron,Wisconsin,2,1,0,1
Iroquois,Illinois,12,0,0,12
Irwin,Georgia,13,0,0,13
Isabella,Michigan,46,6,0,40
Isanti,Minnesota,4,0,0,4
Island,Washington,165,8,0,157
Isle of Wight,Virginia,69,0,0,69
Itasca,Minnesota,2,0,0,2
Itawamba,Mississippi,13,1,0,12
Izard,Arkansas,2,0,0,2
Jack,Texas,3,0,0,3
Jackson,Alabama,32,2,0,30
Jackson,Arkansas,1,0,0,1
Jackson,Florida,8,0,0,8
Jackson,Georgia,46,1,0,45
Jackson,Illinois,40,4,0,36
Jackson,Indiana,77,0,0,77
Jackson,Iowa,4,0,0,4
Jackson,Kansas,1,0,0,1
Jackson,Kentucky,43,2,0,41
Jackson,Louisiana,14,0,0,14
Jackson,Michigan,227,9,0,218
Jackson,Minnesota,1,0,0,1
Jackson,Mississippi,196,6,0,190
Jackson,Missouri,267,11,0,256
Jackson,North Carolina,5,0,0,5
Jackson,Ohio,3,0,0,3
Jackson,Oklahoma,6,0,0,6
Jackson,Oregon,48,0,0,48
Jackson,Tennessee,6,0,0,6
Jackson,Texas,4,0,0,4
Jackson,West Virginia,40,1,0,39
Jackson,Wisconsin,11,1,0,10
James City,Virginia,138,2,0,136
Jasper,Georgia,14,0,0,14
Jasper,Illinois,4,1,0,3
Jasper,Indiana,22,1,0,21
Jasper,Iowa,28,0,0,28
Jasper,Mississippi,20,1,0,19
Jasper,Missouri,28,0,0,28
Jasper,South Carolina,15,0,0,15
Jasper,Texas,7,1,0,6
Jay,Indiana,8,0,0,8
Jeff Davis,Georgia,5,0,0,5
Jefferson,Alabama,651,24,0,627
Jefferson,Arkansas,113,6,0,107
Jefferson,Colorado,860,33,0,827
Jefferson,Florida,23,1,0,22
Jefferson,Georgia,11,1,0,10
Jefferson,Idaho,5,0,0,5
Jefferson,Illinois,11,0,0,11
Jefferson,Indiana,18,0,0,18
Jefferson,Iowa,4,0,0,4
Jefferson,Kansas,6,0,0,6
Jefferson,Kentucky,599,60,0,539
Jefferson,Louisiana,5476,269,0,5207
Jefferson,Mississippi,4,0,0,4
Jefferson,Missouri,179,4,0,175
Jefferson,Montana,2,0,0,2
Jefferson,New York,50,0,0,50
Jefferson,Ohio,24,0,0,24
Jefferson,Oklahoma,1,0,0,1
Jefferson,Oregon,1,0,0,1
Jefferson,Pennsylvania,2,0,0,2
Jefferson,Tennessee,16,1,0,15
Jefferson,Texas,157,7,0,150
Jefferson,Washington,28,0,0,28
Jefferson,West Virginia,60,0,0,60
Jefferson,Wisconsin,27,0,0,27
Jefferson Davis,Louisiana,52,5,0,47
Jefferson Davis,Mississippi,8,1,0,7
Jenkins,Georgia,12,1,0,11
Jennings,Indiana,63,0,0,63
Jerauld,South Dakota,4,0,0,4
Jerome,Idaho,41,2,0,39
Jersey,Illinois,8,0,0,8
Jessamine,Kentucky,31,0,0,31
Jewell,Kansas,3,0,0,3
Jim Wells,Texas,2,0,0,2
Jo Daviess,Illinois,11,0,0,11
Johnson,Arkansas,20,0,0,20
Johnson,Georgia,32,1,0,31
Johnson,Illinois,2,0,0,2
Johnson,Indiana,371,30,0,341
Johnson,Iowa,246,3,0,243
Johnson,Kansas,358,23,0,335
Johnson,Kentucky,1,0,0,1
Johnson,Missouri,48,0,0,48
Johnson,Nebraska,1,0,0,1
Johnson,Tennessee,2,0,0,2
Johnson,Texas,37,1,0,36
Johnson,Wyoming,11,1,0,10
Johnston,North Carolina,114,9,0,105
Johnston,Oklahoma,2,0,0,2
Jones,Georgia,16,0,0,16
Jones,Iowa,13,0,0,13
Jones,Mississippi,56,0,0,56
Jones,North Carolina,9,1,0,8
Jones,Texas,3,0,0,3
Josephine,Oregon,19,1,0,18
Juneau,Alaska,24,0,0,24
Juneau,Wisconsin,7,1,0,6
Juniata,Pennsylvania,63,0,0,63
Kalamazoo,Michigan,130,9,0,121
Kalkaska,Michigan,17,2,0,15
Kanawha,West Virginia,104,0,0,104
Kandiyohi,Minnesota,2,0,0,2
Kane,Illinois,538,28,0,510
Kankakee,Illinois,260,10,0,250
Kansas City,Missouri,401,13,0,388
Karnes,Texas,3,0,0,3
Kauai,Hawaii,21,0,0,21
Kaufman,Texas,38,0,0,38
Kay,Oklahoma,46,4,0,42
Kearney,Nebraska,3,0,0,3
Kearny,Kansas,0,0,0,0
Kemper,Mississippi,16,0,0,16
Kenai Peninsula,Alaska,17,0,0,17
Kendall,Illinois,123,2,0,121
Kendall,Texas,14,0,0,14
Kennebec,Maine,95,3,0,92
Kenosha,Wisconsin,218,5,0,213
Kent,Delaware,384,9,0,375
Kent,Maryland,14,1,0,13
Kent,Michigan,430,20,0,410
Kent,Rhode Island,299,0,0,299
Kenton,Kentucky,121,10,0,111
Keokuk,Iowa,2,0,0,2
Kern,California,578,3,0,575
Kerr,Texas,4,0,0,4
Kershaw,South Carolina,190,8,0,182
Ketchikan Gateway,Alaska,15,0,0,15
Kewaunee,Wisconsin,8,1,0,7
Kimball,Nebraska,9,0,0,9
King,Washington,4902,331,0,4571
King George,Virginia,18,0,0,18
King William,Virginia,2,0,0,2
King and Queen,Virginia,2,0,0,2
Kingfisher,Oklahoma,6,0,0,6
Kings,California,18,1,0,17
Kingsbury,South Dakota,0,0,0,0
Kiowa,Oklahoma,2,0,0,2
Kit Carson,Colorado,13,1,0,12
Kitsap,Washington,135,1,0,134
Kittitas,Washington,14,0,0,14
Klamath,Oregon,29,0,0,29
Kleberg,Texas,5,1,0,4
Klickitat,Washington,16,3,0,13
Knott,Kentucky,2,0,0,2
Knox,Illinois,3,0,0,3
Knox,Indiana,16,0,0,16
Knox,Kentucky,4,0,0,4
Knox,Maine,12,0,0,12
Knox,Nebraska,2,0,0,2
Knox,Ohio,11,1,0,10
Knox,Tennessee,182,4,0,178
Knox,Texas,1,0,0,1
Kodiak Island,Alaska,1,0,0,1
Koochiching,Minnesota,1,0,0,1
Kootenai,Idaho,49,0,0,49
Kosciusko,Indiana,22,1,0,21
Kossuth,Iowa,1,0,0,1
La Crosse,Wisconsin,25,0,0,25
La Paz,Arizona,5,0,0,5
La Plata,Colorado,47,0,0,47
La Salle,Texas,1,0,0,1
LaGrange,Indiana,16,1,0,15
LaPorte,Indiana,129,5,0,124
LaSalle,Illinois,27,1,0,26
LaSalle,Louisiana,13,0,0,13
Labette,Kansas,20,0,0,20
Lac qui Parle,Minnesota,1,0,0,1
Lackawanna,Pennsylvania,592,30,0,562
Lafayette,Arkansas,5,0,0,5
Lafayette,Florida,1,0,0,1
Lafayette,Louisiana,396,17,0,379
Lafayette,Mississippi,39,2,0,37
Lafayette,Missouri,29,1,0,28
Lafayette,Wisconsin,3,0,0,3
Lafourche,Louisiana,542,21,0,521
Lake,California,6,0,0,6
Lake,Colorado,8,0,0,8
Lake,Florida,197,5,0,192
Lake,Illinois,1914,71,0,1843
Lake,Indiana,1026,42,0,984
Lake,Michigan,2,0,0,2
Lake,Montana,5,0,0,5
Lake,Ohio,130,6,0,124
Lake,South Dakota,3,0,0,3
Lake,Tennessee,4,0,0,4
Lamar,Alabama,7,0,0,7
Lamar,Georgia,21,0,0,21
Lamar,Mississippi,57,1,0,56
Lamar,Texas,7,0,0,7
Lamb,Texas,2,0,0,2
Lamoille,Vermont,22,2,0,20
Lampasas,Texas,2,0,0,2
Lancaster,Nebraska,62,1,0,61
Lancaster,Pennsylvania,1030,35,0,995
Lancaster,South Carolina,73,2,0,71
Lancaster,Virginia,1,0,0,1
Lane,Oregon,46,1,0,45
Lanier,Georgia,6,1,0,5
Lapeer,Michigan,140,13,0,127
Laramie,Wyoming,69,0,0,69
Larimer,Colorado,217,9,0,208
Larue,Kentucky,5,0,0,5
Las Animas,Colorado,3,0,0,3
Latah,Idaho,3,0,0,3
Latimer,Oklahoma,4,1,0,3
Lauderdale,Alabama,23,4,0,19
Lauderdale,Mississippi,181,13,0,168
Lauderdale,Tennessee,12,0,0,12
Laurel,Kentucky,13,2,0,11
Laurens,Georgia,39,1,0,38
Laurens,South Carolina,19,1,0,18
Lavaca,Texas,4,0,0,4
Lawrence,Alabama,8,0,0,8
Lawrence,Arkansas,24,1,0,23
Lawrence,Illinois,2,0,0,2
Lawrence,Indiana,76,9,0,67
Lawrence,Kentucky,1,0,0,1
Lawrence,Mississippi,12,0,0,12
Lawrence,Ohio,20,0,0,20
Lawrence,Pennsylvania,59,5,0,54
Lawrence,South Dakota,9,0,0,9
Lawrence,Tennessee,15,0,0,15
Le Flore,Oklahoma,5,0,0,5
Le Sueur,Minnesota,22,0,0,22
Lea,New Mexico,2,0,0,2
Leake,Mississippi,60,1,0,59
Leavenworth,Kansas,115,1,0,114
Lebanon,Pennsylvania,424,2,0,422
Lee,Alabama,301,12,0,289
Lee,Arkansas,3,1,0,2
Lee,Florida,721,25,0,696
Lee,Georgia,269,15,0,254
Lee,Illinois,17,0,0,17
Lee,Iowa,3,0,0,3
Lee,Mississippi,49,4,0,45
Lee,North Carolina,30,0,0,30
Lee,South Carolina,40,5,0,35
Lee,Texas,2,0,0,2
Lee,Virginia,7,0,0,7
Leelanau,Michigan,7,0,0,7
Leflore,Mississippi,70,6,0,64
Lehigh,Pennsylvania,2092,29,0,2063
Lenawee,Michigan,59,0,0,59
Lenoir,North Carolina,17,1,0,16
Leon,Florida,174,0,0,174
Leon,Texas,5,0,0,5
Leslie,Kentucky,2,0,0,2
Letcher,Kentucky,1,0,0,1
Levy,Florida,9,0,0,9
Lewis,Idaho,0,0,0,0
Lewis,Kentucky,2,0,0,2
Lewis,New York,8,0,0,8
Lewis,Tennessee,2,0,0,2
Lewis,Washington,19,2,0,17
Lewis,West Virginia,2,0,0,2
Lewis and Clark,Montana,16,0,0,16
Lexington,South Carolina,267,9,0,258
Lexington,Virginia,3,0,0,3
Liberty,Florida,2,0,0,2
Liberty,Georgia,31,0,0,31
Liberty,Montana,1,0,0,1
Liberty,Texas,25,0,0,25
Licking,Ohio,94,4,0,90
Limestone,Alabama,40,0,0,40
Limestone,Texas,11,1,0,10
Lincoln,Arkansas,94,0,0,94
Lincoln,Colorado,2,0,0,2
Lincoln,Georgia,9,0,0,9
Lincoln,Idaho,15,0,0,15
Lincoln,Kentucky,4,1,0,3
Lincoln,Louisiana,47,2,0,45
Lincoln,Maine,12,0,0,12
Lincoln,Minnesota,2,0,0,2
Lincoln,Mississippi,95,6,0,89
Lincoln,Missouri,35,1,0,34
Lincoln,Montana,7,1,0,6
Lincoln,Nebraska,17,1,0,16
Lincoln,Nevada,0,0,0,0
Lincoln,New Mexico,1,0,0,1
Lincoln,North Carolina,20,0,0,20
Lincoln,Oklahoma,11,0,0,11
Lincoln,Oregon,4,0,0,4
Lincoln,South Dakota,77,0,0,77
Lincoln,Tennessee,9,0,0,9
Lincoln,Washington,2,0,0,2
Lincoln,West Virginia,1,0,0,1
Lincoln,Wyoming,5,0,0,5
Linn,Iowa,304,22,0,282
Linn,Kansas,6,0,0,6
Linn,Missouri,5,1,0,4
Linn,Oregon,57,6,0,51
Litchfield,Connecticut,569,46,0,523
Live Oak,Texas,3,0,0,3
Livingston,Illinois,18,0,0,18
Livingston,Kentucky,1,0,0,1
Livingston,Louisiana,142,7,0,135
Livingston,Michigan,269,9,0,260
Livingston,Missouri,2,0,0,2
Livingston,New York,34,3,0,31
Llano,Texas,3,0,0,3
Logan,Arkansas,2,0,0,2
Logan,Colorado,17,0,0,17
Logan,Illinois,5,0,0,5
Logan,Kentucky,8,0,0,8
Logan,Nebraska,0,0,0,0
Logan,Ohio,12,0,0,12
Logan,Oklahoma,8,0,0,8
Logan,West Virginia,8,1,0,7
Long,Georgia,2,0,0,2
Lonoke,Arkansas,30,0,0,30
Lorain,Ohio,245,14,0,231
Los Alamos,New Mexico,6,0,0,6
Los Angeles,California,11400,497,0,10903
Loudon,Tennessee,19,0,0,19
Loudoun,Virginia,385,8,0,377
Louisa,Iowa,169,1,0,168
Louisa,Virginia,33,0,0,33
Love,Oklahoma,2,0,0,2
Lowndes,Alabama,25,0,0,25
Lowndes,Georgia,80,3,0,77
Lowndes,Mississippi,30,1,0,29
Lubbock,Texas,401,28,0,373
Lucas,Ohio,682,28,0,654
Luce,Michigan,1,0,0,1
Lumpkin,Georgia,20,0,0,20
Luna,New Mexico,3,0,0,3
Lunenburg,Virginia,3,0,0,3
Luzerne,Pennsylvania,1668,31,0,1637
Lycoming,Pennsylvania,32,0,0,32
Lyman,South Dakota,2,0,0,2
Lynchburg,Virginia,38,0,0,38
Lynn,Texas,5,0,0,5
Lyon,Iowa,5,0,0,5
Lyon,Kansas,47,0,0,47
Lyon,Kentucky,13,2,0,11
Lyon,Minnesota,6,0,0,6
Lyon,Nevada,12,0,0,12
Mackinac,Michigan,5,0,0,5
Macomb,Michigan,4145,373,0,3772
Macon,Alabama,24,2,0,22
Macon,Georgia,44,0,0,44
Macon,Illinois,47,5,0,42
Macon,Missouri,2,0,0,2
Macon,North Carolina,2,1,0,1
Macon,Tennessee,30,3,0,27
Macoupin,Illinois,18,0,0,18
Madera,California,33,2,0,31
Madison,Alabama,217,4,0,213
Madison,Arkansas,1,0,0,1
Madison,Florida,19,0,0,19
Madison,Georgia,14,1,0,13
Madison,Idaho,8,0,0,8
Madison,Illinois,157,5,0,152
Madison,Indiana,305,28,0,277
Madison,Iowa,3,1,0,2
Madison,Kentucky,21,1,0,20
Madison,Louisiana,4,0,0,4
Madison,Mississippi,123,3,0,120
Madison,Missouri,1,0,0,1
Madison,Montana,8,1,0,7
Madison,Nebraska,7,2,0,5
Madison,New York,117,3,0,114
Madison,Ohio,27,3,0,24
Madison,Tennessee,73,0,0,73
Madison,Texas,1,0,0,1
Madison,Virginia,8,0,0,8
Mahaska,Iowa,7,0,0,7
Mahnomen,Minnesota,1,0,0,1
Mahoning,Ohio,547,44,0,503
Major,Oklahoma,2,1,0,1
Malheur,Oregon,5,0,0,5
Manassas,Virginia,72,0,0,72
Manassas Park,Virginia,21,0,0,21
Manatee,Florida,326,29,0,297
Manistee,Michigan,11,0,0,11
Manitowoc,Wisconsin,5,0,0,5
Marathon,Wisconsin,16,1,0,15
Marengo,Alabama,24,1,0,23
Maricopa,Arizona,2404,69,0,2335
Maries,Missouri,2,0,0,2
Marin,California,187,10,0,177
Marinette,Wisconsin,4,1,0,3
Marion,Alabama,61,4,0,57
Marion,Arkansas,1,0,0,1
Marion,Florida,116,3,0,113
Marion,Georgia,24,1,0,23
Marion,Illinois,17,0,0,17
Marion,Indiana,3518,182,0,3336
Marion,Iowa,3,0,0,3
Marion,Kansas,5,0,0,5
Marion,Kentucky,13,0,0,13
Marion,Mississippi,38,0,0,38
Marion,Ohio,428,1,0,427
Marion,Oregon,317,12,0,305
Marion,South Carolina,14,1,0,13
Marion,Tennessee,27,1,0,26
Marion,Texas,3,0,0,3
Marion,West Virginia,42,1,0,41
Marlboro,South Carolina,25,0,0,25
Marquette,Michigan,29,5,0,24
Marquette,Wisconsin,3,0,0,3
Marshall,Alabama,122,4,0,118
Marshall,Illinois,2,0,0,2
Marshall,Indiana,22,0,0,22
Marshall,Iowa,75,0,0,75
Marshall,Kentucky,12,0,0,12
Marshall,Mississippi,37,2,0,35
Marshall,Oklahoma,1,0,0,1
Marshall,South Dakota,1,0,0,1
Marshall,Tennessee,12,1,0,11
Marshall,West Virginia,8,0,0,8
Martin,Florida,147,4,0,143
Martin,Indiana,5,0,0,5
Martin,Kentucky,2,0,0,2
Martin,Minnesota,39,4,0,35
Martin,North Carolina,8,0,0,8
Martin,Texas,2,0,0,2
Martinsville,Virginia,0,0,0,0
Mason,Illinois,4,0,0,4
Mason,Kentucky,6,0,0,6
Mason,Michigan,4,0,0,4
Mason,Texas,1,0,0,1
Mason,Washington,21,0,0,21
Mason,West Virginia,10,0,0,10
Massac,Illinois,4,0,0,4
Matagorda,Texas,51,3,0,48
Matanuska-Susitna,Alaska,15,0,0,15
Mathews,Virginia,3,0,0,3
Maui,Hawaii,95,3,0,92
Maury,Tennessee,33,0,0,33
Maverick,Texas,12,0,0,12
Mayes,Oklahoma,19,3,0,16
McClain,Oklahoma,20,0,0,20
McCook,South Dakota,3,1,0,2
McCormick,South Carolina,5,1,0,4
McCracken,Kentucky,27,2,0,25
McCreary,Kentucky,9,0,0,9
McCulloch,Texas,3,0,0,3
McCurtain,Oklahoma,7,0,0,7
McDonald,Missouri,4,0,0,4
McDonough,Illinois,3,0,0,3
McDowell,North Carolina,20,0,0,20
McDowell,West Virginia,6,0,0,6
McDuffie,Georgia,35,2,0,33
McHenry,Illinois,306,13,0,293
McHenry,North Dakota,1,1,0,0
McIntosh,Georgia,4,0,0,4
McIntosh,North Dakota,1,0,0,1
McIntosh,Oklahoma,2,0,0,2
McKean,Pennsylvania,4,0,0,4
McKenzie,North Dakota,10,0,0,10
McKinley,New Mexico,265,4,0,261
McLean,Illinois,83,3,0,80
McLean,Kentucky,7,1,0,6
McLean,North Dakota,3,0,0,3
McLennan,Texas,76,4,0,72
McLeod,Minnesota,2,0,0,2
McMinn,Tennessee,6,0,0,6
McNairy,Tennessee,9,0,0,9
McPherson,Kansas,15,0,0,15
Meade,Kentucky,2,1,0,1
Meade,South Dakota,1,0,0,1
Meagher,Montana,1,0,0,1
Mecklenburg,North Carolina,1136,24,0,1112
Mecklenburg,Virginia,62,0,0,62
Mecosta,Michigan,12,1,0,11
Medina,Ohio,130,10,0,120
Medina,Texas,15,2,0,13
Meeker,Minnesota,3,0,0,3
Meigs,Ohio,2,0,0,2
Meigs,Tennessee,3,0,0,3
Menard,Illinois,2,0,0,2
Mendocino,California,4,0,0,4
Menifee,Kentucky,3,0,0,3
Menominee,Michigan,1,0,0,1
Menominee,Wisconsin,1,0,0,1
Merced,California,82,3,0,79
Mercer,Illinois,4,0,0,4
Mercer,Kentucky,9,0,0,9
Mercer,New Jersey,2123,101,0,2022
Mercer,North Dakota,0,0,0,0
Mercer,Ohio,13,1,0,12
Mercer,Pennsylvania,56,1,0,55
Mercer,West Virginia,8,0,0,8
Meriwether,Georgia,39,0,0,39
Merrick,Nebraska,5,0,0,5
Merrimack,New Hampshire,88,0,0,88
Mesa,Colorado,34,0,0,34
Miami,Indiana,21,0,0,21
Miami,Kansas,4,0,0,4
Miami,Ohio,129,22,0,107
Miami-Dade,Florida,8824,195,0,8629
Michigan Department of Corrections (MDOC),Michigan,514,15,0,499
Middlesex,Connecticut,422,32,0,390
Middlesex,Massachusetts,7744,258,0,7486
Middlesex,New Jersey,7308,309,0,6999
Middlesex,Virginia,3,0,0,3
Midland,Michigan,42,1,0,41
Midland,Texas,41,2,0,39
Mifflin,Pennsylvania,17,0,0,17
Milam,Texas,9,0,0,9
Mille Lacs,Minnesota,1,0,0,1
Miller,Arkansas,29,0,0,29
Miller,Georgia,20,0,0,20
Miller,Missouri,1,0,0,1
Mills,Iowa,2,0,0,2
Milwaukee,Wisconsin,2013,120,0,1893
Miner,South Dakota,1,0,0,1
Mineral,Colorado,2,0,0,2
Mineral,West Virginia,8,0,0,8
Mingo,West Virginia,2,0,0,2
Minidoka,Idaho,9,0,0,9
Minnehaha,South Dakota,1157,3,0,1154
Missaukee,Michigan,3,1,0,2
Mississippi,Arkansas,8,0,0,8
Missoula,Montana,34,1,0,33
Mitchell,Georgia,203,22,0,181
Mitchell,Iowa,2,0,0,2
Mitchell,Kansas,2,0,0,2
Mitchell,North Carolina,5,0,0,5
Mitchell,Texas,1,0,0,1
Mobile,Alabama,621,24,0,597
Moffat,Colorado,3,0,0,3
Mohave,Arizona,51,0,0,51
Moniteau,Missouri,19,0,0,19
Monmouth,New Jersey,4414,206,0,4208
Mono,California,23,1,0,22
Monona,Iowa,6,0,0,6
Monongalia,West Virginia,83,2,0,81
Monroe,Alabama,7,1,0,6
Monroe,Arkansas,2,0,0,2
Monroe,Florida,68,3,0,65
Monroe,Georgia,15,1,0,14
Monroe,Illinois,52,6,0,46
Monroe,Indiana,108,3,0,105
Monroe,Kentucky,3,0,0,3
Monroe,Michigan,223,10,0,213
Monroe,Mississippi,58,3,0,55
Monroe,New York,975,62,0,913
Monroe,Ohio,2,0,0,2
Monroe,Pennsylvania,929,29,0,900
Monroe,Tennessee,9,1,0,8
Monroe,West Virginia,2,0,0,2
Monroe,Wisconsin,13,0,0,13
Montague,Texas,5,0,0,5
Montcalm,Michigan,24,1,0,23
Monterey,California,119,3,0,116
Montezuma,Colorado,13,2,0,11
Montgomery,Alabama,207,5,0,202
Montgomery,Georgia,2,0,0,2
Montgomery,Illinois,11,1,0,10
Montgomery,Indiana,25,0,0,25
Montgomery,Iowa,1,0,0,1
Montgomery,Kansas,12,2,0,10
Montgomery,Kentucky,9,0,0,9
Montgomery,Maryland,2280,63,0,2217
Montgomery,Mississippi,15,1,0,14
Montgomery,Missouri,7,0,0,7
Montgomery,New York,33,1,0,32
Montgomery,North Carolina,17,1,0,16
Montgomery,Ohio,222,8,0,214
Montgomery,Pennsylvania,2684,97,0,2587
Montgomery,Tennessee,102,2,0,100
Montgomery,Texas,370,7,0,363
Montgomery,Virginia,40,0,0,40
Montmorency,Michigan,3,0,0,3
Montour,Pennsylvania,48,0,0,48
Montrose,Colorado,69,7,0,62
Moody,South Dakota,1,0,0,1
Moore,North Carolina,89,4,0,85
Moore,Tennessee,1,0,0,1
Moore,Texas,75,0,0,75
Morehouse,Louisiana,34,2,0,32
Morgan,Alabama,46,0,0,46
Morgan,Colorado,122,0,0,122
Morgan,Georgia,19,0,0,19
Morgan,Illinois,12,1,0,11
Morgan,Indiana,111,3,0,108
Morgan,Kentucky,1,0,0,1
Morgan,Missouri,2,0,0,2
Morgan,Ohio,3,0,0,3
Morgan,Tennessee,5,0,0,5
Morgan,West Virginia,8,0,0,8
Morrill,Nebraska,1,0,0,1
Morris,Kansas,2,0,0,2
Morris,New Jersey,3822,232,0,3590
Morris,Texas,4,0,0,4
Morrow,Ohio,16,0,0,16
Morrow,Oregon,5,0,0,5
Morton,Kansas,2,0,0,2
Morton,North Dakota,21,2,0,19
Motley,Texas,1,0,0,1
Moultrie,Illinois,2,0,0,2
Mountrail,North Dakota,29,0,0,29
Mower,Minnesota,25,0,0,25
Muhlenberg,Kentucky,54,2,0,52
Multnomah,Oregon,467,28,0,439
Murray,Georgia,18,0,0,18
Murray,Minnesota,2,0,0,2
Muscatine,Iowa,163,2,0,161
Muscogee,Georgia,207,4,0,203
Muskegon,Michigan,128,5,0,123
Muskingum,Ohio,8,0,0,8
Muskogee,Oklahoma,25,3,0,22
Musselshell,Montana,1,0,0,1
Nacogdoches,Texas,75,6,0,69
Nance,Nebraska,1,0,0,1
Napa,California,44,2,0,42
Nash,North Carolina,52,1,0,51
Nassau,Florida,42,0,0,42
Nassau,New York,28539,1109,0,27430
Natchitoches,Louisiana,50,1,0,49
Natrona,Wyoming,38,0,0,38
Navajo,Arizona,435,1,0,434
Navarro,Texas,20,2,0,18
Nelson,Kentucky,13,0,0,13
Nelson,Virginia,5,0,0,5
Nemaha,Nebraska,1,0,0,1
Neosho,Kansas,2,0,0,2
Neshoba,Mississippi,46,1,0,45
Nevada,Arkansas,1,0,0,1
Nevada,California,34,1,0,33
New Castle,Delaware,1100,30,0,1070
New Hanover,North Carolina,68,1,0,67
New Haven,Connecticut,4520,229,0,4291
New Kent,Virginia,17,0,0,17
New London,Connecticut,292,10,0,282
New Madrid,Missouri,8,0,0,8
New York City,New York,127352,13202,0,114150
Newaygo,Michigan,7,0,0,7
Newberry,South Carolina,23,1,0,22
Newport,Rhode Island,103,0,0,103
Newport News,Virginia,100,1,0,99
Newton,Arkansas,2,0,0,2
Newton,Georgia,121,3,0,118
Newton,Indiana,29,4,0,25
Newton,Mississippi,19,0,0,19
Newton,Missouri,9,0,0,9
Newton,Texas,2,0,0,2
Nez Perce,Idaho,29,10,0,19
Niagara,New York,227,9,0,218
Nicholas,Kentucky,1,0,0,1
Nicholas,West Virginia,3,0,0,3
Nicollet,Minnesota,7,2,0,5
Niobrara,Wyoming,1,0,0,1
Noble,Indiana,29,1,0,28
Noble,Ohio,3,0,0,3
Noble,Oklahoma,6,0,0,6
Nobles,Minnesota,12,0,0,12
Nodaway,Missouri,3,0,0,3
Nome,Alaska,1,0,0,1
Norfolk,Massachusetts,3499,173,0,3326
Norfolk,Virginia,108,2,0,106
Norman,Minnesota,2,0,0,2
Northampton,North Carolina,70,1,0,69
Northampton,Pennsylvania,1335,27,0,1308
Northampton,Virginia,5,0,0,5
Northumberland,Pennsylvania,60,0,0,60
Northumberland,Virginia,5,0,0,5
Norton,Virginia,0,0,0,0
Nottoway,Virginia,5,0,0,5
Nowata,Oklahoma,11,0,0,11
Noxubee,Mississippi,20,0,0,20
Nueces,Texas,87,0,0,87
Nye,Nevada,21,0,0,21
O'Brien,Iowa,3,0,0,3
Oakland,Michigan,5901,442,0,5459
Obion,Tennessee,8,1,0,7
Ocean,New Jersey,4424,201,0,4223
Oceana,Michigan,4,1,0,3
Oconee,Georgia,48,0,0,48
Oconee,South Carolina,14,0,0,14
Oconto,Wisconsin,4,0,0,4
Ogemaw,Michigan,5,0,0,5
Oglala Lakota,South Dakota,1,0,0,1
Ogle,Illinois,40,1,0,39
Oglethorpe,Georgia,32,1,0,31
Ohio,Indiana,1,0,0,1
Ohio,Kentucky,9,0,0,9
Ohio,West Virginia,22,0,0,22
Okaloosa,Florida,124,1,0,123
Okanogan,Washington,15,0,0,15
Okeechobee,Florida,5,0,0,5
Okfuskee,Oklahoma,1,0,0,1
Oklahoma,Oklahoma,497,22,0,475
Okmulgee,Oklahoma,14,0,0,14
Oktibbeha,Mississippi,42,2,0,40
Oldham,Kentucky,23,0,0,23
Oldham,Texas,3,1,0,2
Oliver,North Dakota,1,0,0,1
Olmsted,Minnesota,174,2,0,172
Oneida,New York,261,6,0,255
Oneida,Wisconsin,6,0,0,6
Onondaga,New York,598,17,0,581
Onslow,North Carolina,37,1,0,36
Ontario,New York,67,0,0,67
Ontonagon,Michigan,0,0,0,0
Orange,California,1501,28,0,1473
Orange,Florida,1158,23,0,1135
Orange,Indiana,24,4,0,20
Orange,New York,6514,204,0,6310
Orange,North Carolina,175,3,0,172
Orange,Texas,50,0,0,50
Orange,Vermont,5,0,0,5
Orange,Virginia,19,0,0,19
Orangeburg,South Carolina,41,0,0,41
Oregon,Missouri,1,0,0,1
Orleans,Louisiana,5906,317,0,5589
Orleans,New York,34,1,0,33
Orleans,Vermont,8,0,0,8
Osage,Kansas,4,0,0,4
Osage,Missouri,4,0,0,4
Osage,Oklahoma,61,8,0,53
Osborne,Kansas,2,0,0,2
Osceola,Florida,392,5,0,387
Osceola,Iowa,2,0,0,2
Osceola,Michigan,6,0,0,6
Oscoda,Michigan,4,0,0,4
Oswego,New York,45,2,0,43
Otero,Colorado,5,0,0,5
Otero,New Mexico,3,0,0,3
Otoe,Nebraska,1,0,0,1
Otsego,Michigan,45,3,0,42
Otsego,New York,44,3,0,41
Ottawa,Kansas,3,0,0,3
Ottawa,Michigan,88,5,0,83
Ottawa,Ohio,21,0,0,21
Ottawa,Oklahoma,24,0,0,24
Otter Tail,Minnesota,4,0,0,4
Ouachita,Arkansas,5,0,0,5
Ouachita,Louisiana,470,11,0,459
Ouray,Colorado,4,1,0,3
Out of GA,Georgia,780,7,0,773
Out of HI,Hawaii,6,0,0,6
Out of MI,Michigan,71,2,0,69
Out of OK,Oklahoma,0,0,0,0
Out of TN,Tennessee,250,1,0,249
Outagamie,Wisconsin,31,2,0,29
Overton,Tennessee,7,0,0,7
Owen,Indiana,21,1,0,20
Owsley,Kentucky,2,0,0,2
Owyhee,Idaho,4,0,0,4
Oxford,Maine,13,0,0,13
Ozaukee,Wisconsin,78,9,0,69
Pacific,Washington,1,0,0,1
Page,Iowa,3,0,0,3
Page,Virginia,10,0,0,10
Palm Beach,Florida,2088,115,0,1973
Palo Pinto,Texas,7,1,0,6
Pamlico,North Carolina,6,0,0,6
Panola,Mississippi,27,2,0,25
Panola,Texas,36,3,0,33
Park,Colorado,6,0,0,6
Park,Montana,7,0,0,7
Park,Wyoming,1,0,0,1
Parke,Indiana,8,0,0,8
Parker,Texas,20,0,0,20
Pasco,Florida,193,3,0,190
Pasquotank,North Carolina,20,0,0,20
Passaic,New Jersey,7604,221,0,7383
Patrick,Virginia,0,0,0,0
Paulding,Georgia,132,5,0,127
Paulding,Ohio,5,0,0,5
Pawnee,Oklahoma,28,2,0,26
Payette,Idaho,10,1,0,9
Payne,Oklahoma,34,0,0,34
Peach,Georgia,31,2,0,29
Pearl River,Mississippi,115,8,0,107
Pecos,Texas,5,0,0,5
Pemiscot,Missouri,11,0,0,11
Pend Oreille,Washington,2,0,0,2
Pender,North Carolina,5,0,0,5
Pendleton,Kentucky,5,0,0,5
Pendleton,West Virginia,2,0,0,2
Pennington,South Dakota,10,1,0,9
Penobscot,Maine,40,0,0,40
Peoria,Illinois,34,1,0,33
Pepin,Wisconsin,0,0,0,0
Perquimans,North Carolina,8,0,0,8
Perry,Alabama,9,0,0,9
Perry,Arkansas,3,0,0,3
Perry,Illinois,1,0,0,1
Perry,Indiana,4,0,0,4
Perry,Kentucky,4,0,0,4
Perry,Mississippi,21,1,0,20
Perry,Missouri,41,0,0,41
Perry,Ohio,8,0,0,8
Perry,Pennsylvania,18,1,0,17
Perry,Tennessee,6,0,0,6
Person,North Carolina,15,0,0,15
Petersburg,Alaska,2,0,0,2
Petersburg,Virginia,21,0,0,21
Pettis,Missouri,10,0,0,10
Phelps,Missouri,1,0,0,1
Phelps,Nebraska,1,0,0,1
Philadelphia,Pennsylvania,8563,298,0,8265
Phillips,Arkansas,4,1,0,3
Phillips,Colorado,4,0,0,4
Phillips,Kansas,1,0,0,1
Piatt,Illinois,7,0,0,7
Pickaway,Ohio,253,4,0,249
Pickens,Alabama,32,0,0,32
Pickens,Georgia,15,2,0,13
Pickens,South Carolina,36,0,0,36
Pierce,Georgia,49,2,0,47
Pierce,Nebraska,1,0,0,1
Pierce,North Dakota,2,0,0,2
Pierce,Washington,1086,28,0,1058
Pierce,Wisconsin,7,0,0,7
Pike,Alabama,29,0,0,29
Pike,Arkansas,2,0,0,2
Pike,Georgia,29,1,0,28
Pike,Illinois,1,0,0,1
Pike,Indiana,1,0,0,1
Pike,Kentucky,6,1,0,5
Pike,Mississippi,93,2,0,91
Pike,Missouri,6,0,0,6
Pike,Ohio,1,0,0,1
Pike,Pennsylvania,290,8,0,282
Pima,Arizona,819,29,0,790
Pinal,Arizona,212,0,0,212
Pine,Minnesota,9,0,0,9
Pinellas,Florida,565,16,0,549
Pipestone,Minnesota,1,0,0,1
Pitkin,Colorado,51,2,0,49
Pitt,North Carolina,85,1,0,84
Pittsburg,Oklahoma,14,1,0,13
Pittsylvania,Virginia,6,0,0,6
Placer,California,130,8,0,122
Plaquemines,Louisiana,152,11,0,141
Platte,Missouri,27,0,0,27
Platte,Nebraska,6,0,0,6
Platte,Wyoming,0,0,0,0
Pleasants,West Virginia,1,0,0,1
Plumas,California,4,0,0,4
Plymouth,Iowa,6,0,0,6
Plymouth,Massachusetts,2577,93,0,2484
Poinsett,Arkansas,10,0,0,10
Pointe Coupee,Louisiana,62,5,0,57
Polk,Arkansas,7,0,0,7
Polk,Florida,316,12,0,304
Polk,Georgia,29,0,0,29
Polk,Iowa,277,10,0,267
Polk,Minnesota,2,0,0,2
Polk,Missouri,1,0,0,1
Polk,Nebraska,4,0,0,4
Polk,North Carolina,9,0,0,9
Polk,Oregon,31,1,0,30
Polk,Tennessee,5,0,0,5
Polk,Texas,14,0,0,14
Polk,Wisconsin,4,0,0,4
Pondera,Montana,1,0,0,1
Pontotoc,Mississippi,17,2,0,15
Pontotoc,Oklahoma,10,1,0,9
Pope,Arkansas,33,0,0,33
Poquoson,Virginia,6,0,0,6
Portage,Ohio,166,24,0,142
Portage,Wisconsin,4,0,0,4
Porter,Indiana,155,2,0,153
Portsmouth,Virginia,63,4,0,59
Posey,Indiana,6,0,0,6
Pottawatomie,Kansas,5,0,0,5
Pottawatomie,Oklahoma,32,3,0,29
Pottawattamie,Iowa,18,1,0,17
Potter,Pennsylvania,4,0,0,4
Potter,Texas,101,2,0,99
Powell,Kentucky,1,0,0,1
Power,Idaho,2,0,0,2
Poweshiek,Iowa,7,1,0,6
Powhatan,Virginia,7,0,0,7
Prairie,Arkansas,2,0,0,2
Pratt,Kansas,1,0,0,1
Preble,Ohio,21,1,0,20
Prentiss,Mississippi,16,0,0,16
Presque Isle,Michigan,2,0,0,2
Preston,West Virginia,6,0,0,6
Price,Wisconsin,1,0,0,1
Prince Edward,Virginia,17,0,0,17
Prince George,Virginia,28,0,0,28
Prince George's,Maryland,2966,77,0,2889
Prince William,Virginia,644,1,0,643
Prince of Wales-Hyder,Alaska,2,0,0,2
Providence,Rhode Island,2703,3,0,2700
Prowers,Colorado,1,0,0,1
Pueblo,Colorado,72,5,0,67
Pulaski,Arkansas,360,11,0,349
Pulaski,Georgia,16,1,0,15
Pulaski,Illinois,5,0,0,5
Pulaski,Indiana,1,0,0,1
Pulaski,Kentucky,34,2,0,32
Pulaski,Missouri,25,1,0,24
Pulaski,Virginia,8,0,0,8
Putnam,Florida,52,1,0,51
Putnam,Georgia,14,0,0,14
Putnam,Indiana,47,4,0,43
Putnam,New York,732,7,0,725
Putnam,Ohio,13,0,0,13
Putnam,Tennessee,93,2,0,91
Putnam,West Virginia,14,0,0,14
Quay,New Mexico,1,0,0,1
Queen Anne's,Maryland,19,1,0,18
Quitman,Georgia,3,1,0,2
Quitman,Mississippi,13,0,0,13
Rabun,Georgia,7,0,0,7
Racine,Wisconsin,157,8,0,149
Radford,Virginia,1,0,0,1
Rains,Texas,2,0,0,2
Raleigh,West Virginia,7,0,0,7
Ralls,Missouri,1,0,0,1
Ramsey,Minnesota,178,9,0,169
Ramsey,North Dakota,3,0,0,3
Randall,Texas,93,2,0,91
Randolph,Alabama,51,4,0,47
Randolph,Arkansas,10,0,0,10
Randolph,Georgia,139,12,0,127
Randolph,Illinois,48,1,0,47
Randolph,Indiana,10,1,0,9
Randolph,Missouri,8,0,0,8
Randolph,North Carolina,67,2,0,65
Randolph,West Virginia,4,0,0,4
Rankin,Mississippi,128,2,0,126
Rapides,Louisiana,196,7,0,189
Rappahannock,Virginia,1,0,0,1
Ravalli,Montana,5,0,0,5
Ray,Missouri,7,0,0,7
Red Lake,Minnesota,1,0,0,1
Red River,Louisiana,18,3,0,15
Red River,Texas,1,0,0,1
Redwood,Minnesota,1,0,0,1
Reeves,Texas,2,0,0,2
Reno,Kansas,14,0,0,14
Rensselaer,New York,150,6,0,144
Renville,Minnesota,3,0,0,3
Republic,Kansas,4,0,0,4
Reynolds,Missouri,2,0,0,2
Rhea,Tennessee,0,0,0,0
Rice,Minnesota,6,1,0,5
Richland,Illinois,2,0,0,2
Richland,Louisiana,27,0,0,27
Richland,Montana,3,0,0,3
Richland,North Dakota,4,0,0,4
Richland,Ohio,50,1,0,49
Richland,South Carolina,612,14,0,598
Richland,Wisconsin,8,1,0,7
Richmond,Georgia,238,10,0,228
Richmond,North Carolina,17,2,0,15
Richmond,Virginia,8,0,0,8
Richmond City,Virginia,201,10,0,191
Riley,Kansas,27,0,0,27
Rio Arriba,New Mexico,10,0,0,10
Rio Blanco,Colorado,1,0,0,1
Rio Grande,Colorado,7,0,0,7
Ripley,Indiana,77,3,0,74
Ripley,Missouri,3,0,0,3
Riverside,California,2457,69,0,2388
Roane,Tennessee,7,0,0,7
Roane,West Virginia,2,0,0,2
Roanoke,Virginia,20,0,0,20
Roanoke City,Virginia,24,0,0,24
Roberts,South Dakota,4,0,0,4
Roberts,Texas,1,0,0,1
Robertson,Tennessee,95,0,0,95
Robertson,Texas,2,0,0,2
Robeson,North Carolina,20,0,0,20
Rock,Minnesota,3,0,0,3
Rock,Wisconsin,63,4,0,59
Rock Island,Illinois,167,4,0,163
Rockbridge,Virginia,5,0,0,5
Rockcastle,Kentucky,11,0,0,11
Rockdale,Georgia,116,6,0,110
Rockingham,New Hampshire,449,1,0,448
Rockingham,North Carolina,16,2,0,14
Rockingham,Virginia,83,0,0,83
Rockland,New York,8987,319,0,8668
Rockwall,Texas,39,0,0,39
Rogers,Oklahoma,30,2,0,28
Rolette,North Dakota,1,0,0,1
Rooks,Kansas,3,0,0,3
Roosevelt,Montana,6,0,0,6
Roosevelt,New Mexico,1,0,0,1
Roscommon,Michigan,9,0,0,9
Roseau,Minnesota,1,0,0,1
Ross,Ohio,28,0,0,28
Routt,Colorado,43,1,0,42
Rowan,Kentucky,2,0,0,2
Rowan,North Carolina,231,12,0,219
Rush,Indiana,20,1,0,19
Rusk,Texas,27,1,0,26
Rusk,Wisconsin,3,0,0,3
Russell,Alabama,35,0,0,35
Russell,Kentucky,11,2,0,9
Russell,Virginia,2,0,0,2
Rutherford,North Carolina,59,2,0,57
Rutherford,Tennessee,271,6,0,265
Rutland,Vermont,41,1,0,40
Sabine,Louisiana,13,0,0,13
Sabine,Texas,1,0,0,1
Sacramento,California,896,32,0,864
Sagadahoc,Maine,15,0,0,15
Saginaw,Michigan,369,24,0,345
Saguache,Colorado,3,0,0,3
Salem,New Jersey,102,4,0,98
Salem,Virginia,6,0,0,6
Saline,Arkansas,37,1,0,36
Saline,Illinois,3,0,0,3
Saline,Kansas,15,2,0,13
Saline,Missouri,53,0,0,53
Saline,Nebraska,3,0,0,3
Salt Lake,Utah,1456,12,0,1444
Saluda,South Carolina,9,0,0,9
Sampson,North Carolina,18,0,0,18
San Augustine,Texas,14,1,0,13
San Benito,California,44,2,0,42
San Bernardino,California,1032,47,0,985
San Diego,California,2087,63,0,2024
San Francisco,California,1058,20,0,1038
San Jacinto,Texas,10,0,0,10
San Joaquin,California,371,17,0,354
San Juan,New Mexico,229,13,0,216
San Juan,Utah,17,2,0,15
San Juan,Washington,13,0,0,13
San Luis Obispo,California,127,1,0,126
San Mateo,California,797,28,0,769
San Miguel,Colorado,12,0,0,12
San Miguel,New Mexico,2,0,0,2
San Patricio,Texas,8,0,0,8
Sanborn,South Dakota,3,0,0,3
Sandoval,New Mexico,293,5,0,288
Sandusky,Ohio,16,2,0,14
Sangamon,Illinois,58,3,0,55
Sanilac,Michigan,27,3,0,24
Santa Barbara,California,354,3,0,351
Santa Clara,California,1870,73,0,1797
Santa Cruz,Arizona,14,0,0,14
Santa Cruz,California,98,2,0,96
Santa Fe,New Mexico,79,0,0,79
Santa Rosa,Florida,130,6,0,124
Sarasota,Florida,274,22,0,252
Saratoga,New York,236,4,0,232
Sargent,North Dakota,1,0,0,1
Sarpy,Nebraska,47,0,0,47
Sauk,Wisconsin,31,3,0,28
Saunders,Nebraska,6,0,0,6
Sawyer,Wisconsin,2,0,0,2
Schenectady,New York,295,8,0,287
Schley,Georgia,15,1,0,14
Schoharie,New York,20,0,0,20
Schoolcraft,Michigan,3,0,0,3
Schuyler,Illinois,1,0,0,1
Schuyler,New York,8,0,0,8
Schuylkill,Pennsylvania,244,4,0,240
Scioto,Ohio,5,0,0,5
Scotland,Missouri,4,0,0,4
Scotland,North Carolina,11,0,0,11
Scott,Arkansas,1,0,0,1
Scott,Indiana,20,2,0,18
Scott,Iowa,155,3,0,152
Scott,Kansas,1,0,0,1
Scott,Kentucky,22,0,0,22
Scott,Minnesota,23,1,0,22
Scott,Mississippi,96,0,0,96
Scott,Missouri,42,0,0,42
Scott,Tennessee,11,0,0,11
Scott,Virginia,3,0,0,3
Scotts Bluff,Nebraska,17,0,0,17
Screven,Georgia,11,1,0,10
Scurry,Texas,2,0,0,2
Searcy,Arkansas,6,0,0,6
Sebastian,Arkansas,11,0,0,11
Sedgwick,Kansas,231,3,0,228
Seminole,Florida,313,4,0,309
Seminole,Georgia,19,2,0,17
Seminole,Oklahoma,7,1,0,6
Seneca,New York,18,0,0,18
Seneca,Ohio,11,1,0,10
Sequatchie,Tennessee,3,0,0,3
Sequoyah,Oklahoma,10,2,0,8
Sevier,Arkansas,8,0,0,8
Sevier,Tennessee,22,0,0,22
Seward,Kansas,24,0,0,24
Seward,Nebraska,1,0,0,1
Sharkey,Mississippi,3,0,0,3
Sharp,Arkansas,2,0,0,2
Shasta,California,26,3,0,23
Shawano,Wisconsin,6,0,0,6
Shawnee,Kansas,90,5,0,85
Sheboygan,Wisconsin,38,2,0,36
Shelby,Alabama,248,8,0,240
Shelby,Illinois,4,0,0,4
Shelby,Indiana,97,4,0,93
Shelby,Iowa,9,0,0,9
Shelby,Kentucky,22,2,0,20
Shelby,Missouri,1,0,0,1
Shelby,Ohio,28,0,0,28
Shelby,Tennessee,1492,33,0,1459
Shelby,Texas,53,0,0,53
Shenandoah,Virginia,33,0,0,33
Sherburne,Minnesota,12,0,0,12
Sheridan,Wyoming,12,0,0,12
Sherman,Kansas,1,0,0,1
Sherman,Oregon,1,0,0,1
Sherman,Texas,6,0,0,6
Shiawassee,Michigan,86,2,0,84
Sibley,Minnesota,1,0,0,1
Silver Bow,Montana,11,0,0,11
Simpson,Kentucky,20,2,0,18
Simpson,Mississippi,14,0,0,14
Sioux,Iowa,7,0,0,7
Sioux,North Dakota,1,0,0,1
Siskiyou,California,5,0,0,5
Skagit,Washington,218,6,0,212
Skamania,Washington,3,0,0,3
Slope,North Dakota,3,0,0,3
Smith,Kansas,2,0,0,2
Smith,Mississippi,38,1,0,37
Smith,Tennessee,11,1,0,10
Smith,Texas,112,2,0,110
Smyth,Virginia,11,0,0,11
Snohomish,Washington,2056,88,0,1968
Snyder,Pennsylvania,25,1,0,24
Socorro,New Mexico,20,0,0,20
Solano,California,169,2,0,167
Somerset,Maine,15,0,0,15
Somerset,Maryland,9,0,0,9
Somerset,New Jersey,2195,135,0,2060
Somerset,Pennsylvania,15,0,0,15
Sonoma,California,172,2,0,170
Southampton,Virginia,7,0,0,7
Southeast Fairbanks,Alaska,1,0,0,1
Spalding,Georgia,119,5,0,114
Spartanburg,South Carolina,204,5,0,199
Spencer,Indiana,4,0,0,4
Spencer,Kentucky,8,0,0,8
Spink,South Dakota,3,0,0,3
Spokane,Washington,298,17,0,281
Spotsylvania,Virginia,69,0,0,69
St. Bernard,Louisiana,404,11,0,393
St. Charles,Louisiana,471,26,0,445
St. Charles,Missouri,426,17,0,409
St. Clair,Alabama,52,0,0,52
St. Clair,Illinois,254,17,0,237
St. Clair,Michigan,236,8,0,228
St. Clair,Missouri,2,0,0,2
St. Croix,Wisconsin,11,0,0,11
St. Francis,Arkansas,63,0,0,63
St. Francois,Missouri,24,1,0,23
St. Helena,Louisiana,18,1,0,17
St. James,Louisiana,216,14,0,202
St. John the Baptist,Louisiana,623,50,0,573
St. Johns,Florida,186,4,0,182
St. Joseph,Indiana,358,7,0,351
St. Joseph,Michigan,23,1,0,22
St. Landry,Louisiana,119,18,0,101
St. Lawrence,New York,96,0,0,96
St. Louis,Minnesota,45,7,0,38
St. Louis,Missouri,2088,72,0,2016
St. Louis City,Missouri,766,28,0,738
St. Lucie,Florida,192,11,0,181
St. Martin,Louisiana,184,10,0,174
St. Mary,Louisiana,137,9,0,128
St. Mary's,Maryland,100,1,0,99
St. Tammany,Louisiana,961,66,0,895
Stafford,Kansas,1,0,0,1
Stafford,Virginia,128,0,0,128
Stanislaus,California,187,4,0,183
Stanly,North Carolina,20,2,0,18
Stanton,Kansas,3,0,0,3
Stanton,Nebraska,1,0,0,1
Stark,Illinois,1,0,0,1
Stark,North Dakota,37,2,0,35
Stark,Ohio,210,22,0,188
Starke,Indiana,10,1,0,9
Starr,Texas,7,0,0,7
Staunton,Virginia,4,0,0,4
Ste. Genevieve,Missouri,7,1,0,6
Stearns,Minnesota,14,0,0,14
Steele,Minnesota,9,0,0,9
Stephens,Georgia,28,1,0,27
Stephens,Oklahoma,15,1,0,14
Stephens,Texas,1,0,0,1
Stephenson,Illinois,10,0,0,10
Steuben,Indiana,16,1,0,15
Steuben,New York,154,18,0,136
Stevens,Kansas,3,0,0,3
Stevens,Washington,7,1,0,6
Stewart,Georgia,13,0,0,13
Stewart,Tennessee,4,0,0,4
Stillwater,Montana,1,0,0,1
Stoddard,Missouri,15,0,0,15
Stokes,North Carolina,10,0,0,10
Stone,Arkansas,7,0,0,7
Stone,Mississippi,17,0,0,17
Stone,Missouri,3,0,0,3
Story,Iowa,17,0,0,17
Strafford,New Hampshire,84,0,0,84
Stutsman,North Dakota,1,0,0,1
Sublette,Wyoming,1,0,0,1
Suffolk,Massachusetts,7272,164,0,7108
Suffolk,New York,25035,693,0,24342
Suffolk,Virginia,70,0,0,70
Sullivan,Indiana,7,0,0,7
Sullivan,New Hampshire,9,0,0,9
Sullivan,New York,505,11,0,494
Sullivan,Pennsylvania,1,0,0,1
Sullivan,Tennessee,45,1,0,44
Sully,South Dakota,1,0,0,1
Summers,West Virginia,1,0,0,1
Summit,Colorado,93,1,0,92
Summit,Ohio,323,17,0,306
Summit,Utah,311,0,0,311
Sumner,Kansas,3,1,0,2
Sumner,Tennessee,491,28,0,463
Sumter,Alabama,33,0,0,33
Sumter,Florida,120,11,0,109
Sumter,Georgia,302,14,0,288
Sumter,South Carolina,176,6,0,170
Sunflower,Mississippi,45,2,0,43
Surry,North Carolina,16,0,0,16
Surry,Virginia,3,0,0,3
Susquehanna,Pennsylvania,58,1,0,57
Sussex,Delaware,811,22,0,789
Sussex,New Jersey,591,54,0,537
Sussex,Virginia,11,0,0,11
Sutter,California,24,2,0,22
Suwannee,Florida,87,5,0,82
Sweetwater,Wyoming,10,0,0,10
Swift,Minnesota,1,0,0,1
Swisher,Texas,4,0,0,4
Switzerland,Indiana,12,0,0,12
Talbot,Georgia,16,1,0,15
Talbot,Maryland,14,1,0,13
Talladega,Alabama,42,1,0,41
Tallahatchie,Mississippi,8,1,0,7
Tallapoosa,Alabama,160,9,0,151
Tama,Iowa,121,5,0,116
Taney,Missouri,8,1,0,7
Tangipahoa,Louisiana,435,18,0,417
Taos,New Mexico,15,0,0,15
Tarrant,Texas,1175,35,0,1140
Tate,Mississippi,27,0,0,27
Tattnall,Georgia,5,0,0,5
Taylor,Florida,1,0,0,1
Taylor,Georgia,10,2,0,8
Taylor,Iowa,1,0,0,1
Taylor,Kentucky,4,0,0,4
Taylor,Texas,89,2,0,87
Taylor,West Virginia,5,0,0,5
Tazewell,Illinois,21,3,0,18
Tazewell,Virginia,4,0,0,4
Tehama,California,1,1,0,0
Telfair,Georgia,13,0,0,13
Teller,Colorado,17,2,0,15
Tensas,Louisiana,1,0,0,1
Terrebonne,Louisiana,293,18,0,275
Terrell,Georgia,139,13,0,126
Terry,Texas,10,0,0,10
Teton,Idaho,7,0,0,7
Teton,Wyoming,61,0,0,61
Texas,Missouri,0,0,0,0
Texas,Oklahoma,9,1,0,8
Thomas,Georgia,112,14,0,98
Thurston,Washington,89,1,0,88
Tift,Georgia,81,4,0,77
Tillamook,Oregon,6,0,0,6
Tillman,Oklahoma,1,0,0,1
Tioga,New York,30,0,0,30
Tioga,Pennsylvania,14,1,0,13
Tippah,Mississippi,45,6,0,39
Tippecanoe,Indiana,53,2,0,51
Tipton,Indiana,10,1,0,9
Tipton,Tennessee,54,0,0,54
Tishomingo,Mississippi,2,0,0,2
Titus,Texas,8,0,0,8
Todd,Kentucky,9,0,0,9
Todd,Minnesota,2,0,0,2
Todd,South Dakota,1,0,0,1
Tolland,Connecticut,258,24,0,234
Tom Green,Texas,41,1,0,40
Tompkins,New York,119,0,0,119
Tooele,Utah,38,0,0,38
Toole,Montana,29,4,0,25
Toombs,Georgia,18,2,0,16
Torrance,New Mexico,12,0,0,12
Towns,Georgia,10,0,0,10
Transylvania,North Carolina,6,0,0,6
Traverse,Minnesota,2,0,0,2
Travis,Texas,1074,21,0,1053
Trempealeau,Wisconsin,1,0,0,1
Treutlen,Georgia,1,0,0,1
Trigg,Kentucky,4,0,0,4
Trimble,Kentucky,2,0,0,2
Trinity,Texas,7,0,0,7
Troup,Georgia,78,4,0,74
Trousdale,Tennessee,19,1,0,18
Trumbull,Ohio,213,15,0,198
Tucker,West Virginia,4,0,0,4
Tulare,California,382,17,0,365
Tulsa,Oklahoma,376,21,0,355
Tunica,Mississippi,28,1,0,27
Tuolumne,California,2,0,0,2
Turner,Georgia,50,1,0,49
Turner,South Dakota,5,0,0,5
Tuscaloosa,Alabama,152,0,0,152
Tuscarawas,Ohio,31,0,0,31
Tuscola,Michigan,54,10,0,44
Twiggs,Georgia,4,0,0,4
Twin Falls,Idaho,100,8,0,92
Tyler,Texas,6,0,0,6
Tyler,West Virginia,3,0,0,3
Tyrrell,North Carolina,4,0,0,4
Uinta,Wyoming,6,0,0,6
Ulster,New York,880,15,0,865
Umatilla,Oregon,23,0,0,23
Unassigned,Alabama,0,0,0,0
Unassigned,Alaska,0,4,0,-4
Unassigned,Arizona,0,42,0,-42
Unassigned,Arkansas,43,0,0,43
Unassigned,California,0,0,0,0
Unassigned,Colorado,96,1,0,95
Unassigned,Connecticut,495,2,0,493
Unassigned,Delaware,22,0,0,22
Unassigned,Florida,4,0,0,4
Unassigned,Georgia,255,0,0,255
Unassigned,Hawaii,5,0,0,5
Unassigned,Idaho,0,0,0,0
Unassigned,Illinois,74,1,0,73
Unassigned,Indiana,0,0,0,0
Unassigned,Iowa,1,0,0,1
Unassigned,Kansas,0,0,0,0
Unassigned,Kentucky,87,1,0,86
Unassigned,Louisiana,56,1,0,55
Unassigned,Maine,1,0,0,1
Unassigned,Massachusetts,760,16,0,744
Unassigned,Michigan,46,4,0,42
Unassigned,Minnesota,0,0,0,0
Unassigned,Mississippi,0,0,0,0
Unassigned,Missouri,0,0,0,0
Unassigned,Montana,0,0,0,0
Unassigned,Nebraska,92,9,0,83
Unassigned,Nevada,98,1,0,97
Unassigned,New Hampshire,2,34,0,-32
Unassigned,New Jersey,719,3,0,716
Unassigned,New Mexico,0,0,0,0
Unassigned,New York,0,574,0,-574
Unassigned,Ohio,0,0,0,0
Unassigned,Oklahoma,108,5,0,103
Unassigned,Oregon,0,0,0,0
Unassigned,Pennsylvania,0,0,0,0
Unassigned,Rhode Island,790,115,0,675
Unassigned,South Dakota,0,0,0,0
Unassigned,Tennessee,209,0,0,209
Unassigned,Utah,0,0,0,0
Unassigned,Vermont,10,0,0,10
Unassigned,Virginia,0,67,0,-67
Unassigned,Washington,334,0,0,334
Unassigned,West Virginia,0,9,0,-9
Unassigned,Wisconsin,0,0,0,0
Unassigned,Wyoming,0,1,0,-1
Unicoi,Tennessee,1,0,0,1
Union,Arkansas,20,0,0,20
Union,Florida,2,0,0,2
Union,Georgia,10,1,0,9
Union,Illinois,4,0,0,4
Union,Indiana,6,0,0,6
Union,Iowa,1,0,0,1
Union,Kentucky,6,0,0,6
Union,Louisiana,71,5,0,66
Union,Mississippi,9,1,0,8
Union,New Jersey,8429,330,0,8099
Union,North Carolina,141,3,0,138
Union,Ohio,12,0,0,12
Union,Oregon,4,0,0,4
Union,Pennsylvania,26,0,0,26
Union,South Carolina,23,0,0,23
Union,South Dakota,4,0,0,4
Union,Tennessee,3,0,0,3
Upshur,Texas,9,0,0,9
Upshur,West Virginia,4,0,0,4
Upson,Georgia,162,8,0,154
Utah,Utah,403,4,0,399
Uvalde,Texas,6,0,0,6
Val Verde,Texas,12,0,0,12
Valencia,New Mexico,24,0,0,24
Valley,Idaho,2,0,0,2
Van Buren,Arkansas,26,2,0,24
Van Buren,Iowa,8,0,0,8
Van Buren,Michigan,28,2,0,26
Van Buren,Tennessee,1,0,0,1
Van Wert,Ohio,2,0,0,2
Van Zandt,Texas,11,1,0,10
Vance,North Carolina,28,1,0,27
Vanderburgh,Indiana,76,1,0,75
Venango,Pennsylvania,6,0,0,6
Ventura,California,396,13,0,383
Vermilion,Illinois,8,0,0,8
Vermilion,Louisiana,28,1,0,27
Vermillion,Indiana,5,0,0,5
Vernon,Louisiana,14,1,0,13
Vernon,Missouri,4,0,0,4
Victoria,Texas,89,1,0,88
Vigo,Indiana,48,3,0,45
Vilas,Wisconsin,4,0,0,4
Virginia Beach,Virginia,265,6,0,259
Volusia,Florida,270,9,0,261
Wabash,Illinois,1,0,0,1
Wabash,Indiana,9,0,0,9
Wabasha,Minnesota,8,0,0,8
Wabaunsee,Kansas,1,0,0,1
Wagoner,Oklahoma,107,7,0,100
Wahkiakum,Washington,2,0,0,2
Wake,North Carolina,574,3,0,571
Wakulla,Florida,14,1,0,13
Waldo,Maine,42,5,0,37
Walker,Alabama,83,0,0,83
Walker,Georgia,13,0,0,13
Walker,Texas,67,0,0,67
Walla Walla,Washington,26,0,0,26
Waller,Texas,23,0,0,23
Wallowa,Oregon,1,0,0,1
Walsh,North Dakota,3,0,0,3
Walthall,Mississippi,22,0,0,22
Walton,Florida,31,0,0,31
Walton,Georgia,59,3,0,56
Walworth,South Dakota,5,0,0,5
Walworth,Wisconsin,75,3,0,72
Wapello,Iowa,6,0,0,6
Ward,North Dakota,20,1,0,19
Ware,Georgia,77,5,0,72
Warren,Georgia,10,0,0,10
Warren,Illinois,2,0,0,2
Warren,Indiana,5,1,0,4
Warren,Iowa,17,0,0,17
Warren,Kentucky,71,0,0,71
Warren,Mississippi,17,1,0,16
Warren,Missouri,18,0,0,18
Warren,New Jersey,521,36,0,485
Warren,New York,91,0,0,91
Warren,North Carolina,3,0,0,3
Warren,Ohio,93,5,0,88
Warren,Pennsylvania,1,0,0,1
Warren,Tennessee,4,0,0,4
Warren,Virginia,22,0,0,22
Warrick,Indiana,53,4,0,49
Wasatch,Utah,103,1,0,102
Wasco,Oregon,10,0,0,10
Waseca,Minnesota,3,0,0,3
Washakie,Wyoming,5,0,0,5
Washburn,Wisconsin,1,0,0,1
Washington,Alabama,14,1,0,13
Washington,Arkansas,45,0,0,45
Washington,Colorado,5,0,0,5
Washington,Florida,6,0,0,6
Washington,Georgia,23,0,0,23
Washington,Idaho,1,0,0,1
Washington,Illinois,5,0,0,5
Washington,Indiana,27,0,0,27
Washington,Iowa,109,5,0,104
Washington,Kentucky,3,0,0,3
Washington,Louisiana,184,11,0,173
Washington,Maine,2,0,0,2
Washington,Maryland,116,1,0,115
Washington,Minnesota,92,3,0,89
Washington,Mississippi,68,2,0,66
Washington,Missouri,4,0,0,4
Washington,Nebraska,20,0,0,20
Washington,New York,48,2,0,46
Washington,North Carolina,18,2,0,16
Washington,Ohio,55,5,0,50
Washington,Oklahoma,124,6,0,118
Washington,Oregon,383,7,0,376
Washington,Pennsylvania,75,1,0,74
Washington,Rhode Island,225,0,0,225
Washington,Tennessee,46,0,0,46
Washington,Texas,49,4,0,45
Washington,Utah,74,1,0,73
Washington,Vermont,30,1,0,29
Washington,Virginia,28,0,0,28
Washington,Wisconsin,81,3,0,78
Washoe,Nevada,572,15,0,557
Washtenaw,Michigan,855,25,0,830
Watauga,North Carolina,8,0,0,8
Watonwan,Minnesota,4,0,0,4
Waukesha,Wisconsin,255,11,0,244
Waupaca,Wisconsin,4,1,0,3
Waushara,Wisconsin,2,0,0,2
Wayne,Georgia,7,0,0,7
Wayne,Indiana,22,2,0,20
Wayne,Kentucky,6,0,0,6
Wayne,Michigan,13233,1044,0,12189
Wayne,Mississippi,10,0,0,10
Wayne,Nebraska,1,0,0,1
Wayne,New York,49,0,0,49
Wayne,North Carolina,246,4,0,242
Wayne,Ohio,72,11,0,61
Wayne,Pennsylvania,81,2,0,79
Wayne,Tennessee,2,0,0,2
Wayne,West Virginia,74,0,0,74
Waynesboro,Virginia,7,0,0,7
Weakley,Tennessee,6,0,0,6
Webb,Texas,245,11,0,234
Weber,Utah,110,1,0,109
Webster,Georgia,4,0,0,4
Webster,Iowa,2,0,0,2
Webster,Kentucky,12,0,0,12
Webster,Louisiana,74,4,0,70
Webster,Mississippi,17,1,0,16
Webster,Missouri,6,0,0,6
Webster,Nebraska,1,0,0,1
Weld,Colorado,960,60,0,900
Wells,Indiana,5,0,0,5
West Baton Rouge,Louisiana,83,9,0,74
West Carroll,Louisiana,4,0,0,4
West Feliciana,Louisiana,60,0,0,60
Westchester,New York,22476,668,0,21808
Westmoreland,Pennsylvania,249,13,0,236
Westmoreland,Virginia,9,0,0,9
Wetzel,West Virginia,3,0,0,3
Wexford,Michigan,7,1,0,6
Wharton,Texas,32,0,0,32
Whatcom,Washington,271,25,0,246
Wheeler,Georgia,3,0,0,3
White,Arkansas,29,0,0,29
White,Georgia,20,0,0,20
White,Indiana,6,0,0,6
White,Tennessee,4,0,0,4
White Pine,Nevada,3,0,0,3
Whiteside,Illinois,31,3,0,28
Whitfield,Georgia,40,3,0,37
Whitley,Indiana,14,1,0,13
Whitley,Kentucky,8,0,0,8
Whitman,Washington,14,0,0,14
Wichita,Texas,57,1,0,56
Wicomico,Maryland,103,1,0,102
Wilbarger,Texas,1,0,0,1
Wilcox,Alabama,40,0,0,40
Wilcox,Georgia,36,0,0,36
Wilkes,Georgia,11,0,0,11
Wilkes,North Carolina,4,1,0,3
Wilkin,Minnesota,7,2,0,5
Wilkinson,Georgia,19,1,0,18
Wilkinson,Mississippi,53,3,0,50
Will,Illinois,1566,90,0,1476
Willacy,Texas,7,1,0,6
Williams,North Dakota,8,0,0,8
Williams,Ohio,6,1,0,5
Williamsburg,South Carolina,19,0,0,19
Williamsburg,Virginia,19,1,0,18
Williamson,Illinois,13,0,0,13
Williamson,Tennessee,324,5,0,319
Williamson,Texas,140,4,0,136
Wilson,Kansas,1,0,0,1
Wilson,North Carolina,96,3,0,93
Wilson,Tennessee,161,1,0,160
Wilson,Texas,19,1,0,18
Winchester,Virginia,22,0,0,22
Windham,Connecticut,92,2,0,90
Windham,Vermont,60,2,0,58
Windsor,Vermont,33,2,0,31
Winkler,Texas,3,0,0,3
Winn,Louisiana,16,2,0,14
Winnebago,Illinois,145,4,0,141
Winnebago,Iowa,2,0,0,2
Winnebago,Wisconsin,34,1,0,33
Winneshiek,Iowa,5,0,0,5
Winona,Minnesota,56,8,0,48
Winston,Alabama,9,0,0,9
Winston,Mississippi,27,0,0,27
Wirt,West Virginia,2,0,0,2
Wise,Texas,8,2,0,6
Wise,Virginia,17,0,0,17
Wood,Ohio,73,6,0,67
Wood,Texas,6,0,0,6
Wood,West Virginia,29,0,0,29
Wood,Wisconsin,2,0,0,2
Woodbury,Iowa,25,0,0,25
Woodford,Illinois,11,0,0,11
Woodford,Kentucky,18,0,0,18
Woodruff,Arkansas,1,0,0,1
Woodson,Kansas,4,0,0,4
Woodward,Oklahoma,1,0,0,1
Worcester,Maryland,28,0,0,28
Worcester,Massachusetts,2765,84,0,2681
Worth,Georgia,116,4,0,112
Worth,Iowa,1,0,0,1
Worth,Missouri,1,0,0,1
Wright,Iowa,1,0,0,1
Wright,Minnesota,23,1,0,22
Wright,Missouri,9,0,0,9
Wyandot,Ohio,16,2,0,14
Wyandotte,Kansas,400,35,0,365
Wyoming,New York,44,3,0,41
Wyoming,Pennsylvania,16,1,0,15
Wyoming,West Virginia,1,0,0,1
Wythe,Virginia,8,0,0,8
Yadkin,North Carolina,11,1,0,10
Yakima,Washington,707,29,0,678
Yalobusha,Mississippi,14,0,0,14
Yamhill,Oregon,35,6,0,29
Yankton,South Dakota,23,0,0,23
Yates,New York,8,0,0,8
Yavapai,Arizona,69,1,0,68
Yazoo,Mississippi,81,1,0,80
Yell,Arkansas,2,0,0,2
Yellow Medicine,Minnesota,3,0,0,3
Yellowstone,Montana,67,0,0,67
Yolo,California,125,7,0,118
York,Maine,170,6,0,164
York,Nebraska,6,0,0,6
York,Pennsylvania,443,4,0,439
York,South Carolina,151,3,0,148
York,Virginia,38,1,0,37
Young,Texas,4,1,0,3
Yuba,California,15,1,0,14
Yukon-Koyukuk,Alaska,1,0,0,1
Yuma,Arizona,28,1,0,27
Yuma,Colorado,2,0,0,2
Zapata,Texas,6,0,0,6
Zavala,Texas,1,0,0,1